state,year,period,ue_rate,ue_qty,lf_qty,em_qty
Montana,2001,M07,3.9,18546,474722,456176
California,2001,M01,5.3,899642,17079464,16179822
Oklahoma,2002,M10,4.6,78188,1689763,1611575
West Virginia,2004,M10,4.4,34710,785334,750624
New Jersey,2002,M05,5.6,244357,4335712,4091355
Texas,2001,M03,4.3,454943,10507490,10052547
Tennessee,2002,M01,6.6,189890,2872341,2682451
Missouri,2011,M12,7.3,219990,3021310,2801320
New York,2001,M07,4.6,424779,9252570,8827791
New Hampshire,2011,M05,5.1,37647,731113,693466
North Carolina,2011,M12,9.7,446758,4620368,4173610
Hawaii,2004,M03,3.6,22038,607202,585164
Nebraska,2009,M05,4.6,46128,995930,949802
New Jersey,2008,M10,5.5,247607,4513199,4265592
North Carolina,2013,M05,8.1,383987,4720818,4336831
New York,2013,M08,7.6,738313,9700699,8962386
South Carolina,2002,M02,6.1,116756,1919284,1802528
Mississippi,2014,M05,7.9,98278,1248718,1150440
Virginia,2005,M08,3.5,139150,3938270,3799120
Mississippi,2011,M01,10.5,140342,1331623,1191281
Connecticut,2015,M08,5.7,108988,1903643,1794655
Missouri,2000,M11,3.6,105656,2974159,2868503
Virginia,2003,M07,4.3,164871,3793360,3628489
Montana,2014,M02,5.8,29457,508901,479444
South Carolina,2016,M09,4.7,108274,2301557,2193283
Vermont,2005,M11,3.2,11411,353197,341786
South Dakota,2002,M11,3.0,12749,418927,406178
North Dakota,2002,M02,4.4,14721,335925,321204
Mississippi,2008,M11,6.4,82683,1288658,1205975
Illinois,2006,M09,4.0,263053,6547180,6284127
New Jersey,2009,M11,9.3,420968,4533942,4112974
Wyoming,2000,M05,3.6,9465,264756,255291
Minnesota,2012,M09,5.0,147817,2948263,2800446
Utah,2005,M10,3.7,47762,1293114,1245352
West Virginia,2013,M07,6.5,52042,806468,754426
Maine,2009,M06,8.1,56998,706248,649250
Georgia,2001,M12,4.7,200563,4295746,4095183
Oklahoma,2011,M07,5.9,104928,1776168,1671240
Nevada,2006,M10,3.8,49411,1303213,1253802
Arizona,2004,M01,5.5,152827,2767352,2614525
Kansas,2007,M10,4.1,60457,1489512,1429055
Pennsylvania,2014,M07,6.5,421989,6497757,6075768
Alabama,2002,M03,6.0,125906,2100861,1974955
New Hampshire,2014,M01,5.2,38348,739485,701137
Maryland,2013,M11,6.1,188644,3115040,2926396
South Carolina,2002,M07,5.7,113287,1974165,1860878
Delaware,2002,M06,4.4,18319,420530,402211
Utah,2003,M11,5.0,60482,1212678,1152196
Indiana,2002,M06,5.4,171944,3203655,3031711
Georgia,2008,M02,5.3,256239,4879900,4623661
New Jersey,2008,M11,5.8,260027,4508499,4248472
Massachusetts,2001,M11,4.0,136597,3394161,3257564
Arizona,2011,M03,9.3,281253,3036772,2755519
New Hampshire,2012,M02,6.1,44557,736080,691523
South Carolina,2005,M06,6.9,144673,2089338,1944665
Georgia,2008,M04,5.0,247179,4904644,4657465
Maine,2010,M06,7.9,55233,702880,647647
Arizona,2014,M09,6.8,212741,3118725,2905984
Missouri,2001,M07,4.5,134979,3023308,2888329
Georgia,2013,M12,7.3,347269,4730003,4382734
Virginia,2008,M11,4.3,178042,4137943,3959901
Tennessee,2002,M05,4.5,131273,2893362,2762089
Pennsylvania,2003,M06,6.0,372626,6234808,5862182
Alabama,2012,M12,7.2,156518,2172728,2016210
Idaho,2006,M09,2.5,18506,746211,727705
Mississippi,2002,M08,6.2,79481,1277169,1197688
Pennsylvania,2002,M01,6.3,389412,6167023,5777611
Kentucky,2008,M03,6.1,123015,2018780,1895765
Delaware,2005,M06,4.5,19591,436287,416696
Pennsylvania,2009,M10,7.9,499083,6332564,5833481
Massachusetts,2011,M04,7.2,246420,3444866,3198446
Florida,2015,M02,5.5,529139,9552816,9023677
Georgia,2015,M03,6.0,284453,4768887,4484434
New York,2003,M12,6.1,564761,9219287,8654526
Florida,2014,M12,5.5,526208,9534403,9008195
Minnesota,2001,M10,3.4,97282,2853612,2756330
Indiana,2001,M06,4.1,129475,3158673,3029198
Vermont,2003,M01,5.1,17614,343345,325731
Virginia,2003,M12,3.6,136053,3746293,3610240
Mississippi,2015,M02,6.5,81403,1246425,1165022
Ohio,2000,M05,3.7,216064,5773545,5557481
Mississippi,2015,M03,6.1,76128,1248135,1172007
Utah,2011,M07,6.8,92535,1357179,1264644
Georgia,2009,M07,10.5,506753,4829639,4322886
North Carolina,2012,M03,9.3,432573,4653067,4220494
Massachusetts,2007,M09,4.5,152391,3412718,3260327
Illinois,2007,M03,4.6,301490,6581515,6280025
New York,2000,M05,4.4,399551,9082939,8683388
Montana,2006,M06,3.6,18361,504498,486137
Pennsylvania,2004,M06,5.7,358495,6270485,5911990
District of Columbia,2005,M08,5.8,18443,317019,298576
New Jersey,2007,M07,4.7,213099,4511222,4298123
Alabama,2000,M12,4.2,90116,2135175,2045059
North Dakota,2007,M10,2.3,8520,367069,358549
Montana,2003,M12,5.0,23386,469562,446176
North Dakota,2013,M07,2.6,10931,415362,404431
Maryland,2003,M11,4.2,121209,2882310,2761101
Kansas,2012,M01,6.4,93872,1478108,1384236
Kentucky,2000,M08,3.9,77023,1956769,1879746
Connecticut,2003,M12,4.6,81653,1767101,1685448
Hawaii,2003,M11,4.1,25077,604829,579752
Rhode Island,2008,M04,6.9,38938,566216,527278
West Virginia,2011,M01,9.6,76926,802036,725110
Illinois,2016,M02,6.6,434443,6555515,6121072
Oklahoma,2013,M01,5.8,104050,1797669,1693619
Virginia,2000,M01,2.9,103763,3569459,3465696
New Mexico,2002,M10,5.2,45788,881231,835443
New Jersey,2006,M02,5.4,240072,4422337,4182265
Pennsylvania,2005,M12,4.4,274461,6238468,5964007
Massachusetts,2012,M04,6.3,216130,3450889,3234759
North Carolina,2001,M10,6.0,251181,4198746,3947565
Missouri,2004,M10,5.5,165807,3011774,2845967
Connecticut,2005,M07,5.2,95731,1832420,1736689
Mississippi,2006,M03,6.2,79274,1276185,1196911
South Dakota,2001,M03,3.4,13958,408463,394505
Virginia,2001,M01,2.6,95076,3640061,3544985
Louisiana,2002,M07,6.4,131281,2035786,1904505
South Dakota,2004,M09,3.4,14584,426505,411921
Nevada,2011,M07,13.1,181299,1378777,1197478
Illinois,2014,M03,8.2,536355,6522081,5985726
Utah,2009,M02,7.2,98703,1373785,1275082
Arkansas,2001,M11,4.8,59535,1248400,1188865
Mississippi,2002,M05,6.5,83042,1284142,1201100
West Virginia,2002,M08,5.7,45907,800228,754321
South Carolina,2004,M10,6.7,137930,2046561,1908631
Iowa,2001,M04,3.2,51997,1605930,1553933
Oklahoma,2004,M08,4.4,74644,1689054,1614410
California,2014,M09,7.0,1310322,18797251,17486929
Missouri,2011,M11,7.2,218735,3031858,2813123
Arizona,2015,M08,6.5,205564,3170906,2965342
South Carolina,2008,M02,5.7,120822,2107293,1986471
Wisconsin,2014,M06,5.6,175909,3124992,2949083
Vermont,2014,M11,3.6,12524,346229,333705
Tennessee,2010,M12,9.2,286253,3110595,2824342
Alabama,2010,M09,9.8,216750,2206969,1990219
Maryland,2000,M04,3.2,89140,2778765,2689625
Michigan,2010,M11,10.9,514760,4713931,4199171
Indiana,2016,M04,4.5,148441,3331392,3182951
Minnesota,2003,M04,4.9,140860,2867918,2727058
California,2005,M10,5.0,885728,17629968,16744240
New Jersey,2006,M11,4.1,180644,4451323,4270679
Montana,2004,M02,5.7,26960,470656,443696
Indiana,2002,M05,5.0,159965,3173414,3013449
Puerto Rico,2007,M07,12.3,168759,1376050,1207291
South Carolina,2014,M01,6.5,140067,2169663,2029596
Delaware,2016,M03,4.5,21451,474004,452553
South Carolina,2005,M05,6.2,128542,2066174,1937632
Idaho,2004,M07,4.3,30814,713351,682537
New Hampshire,2006,M05,3.2,23220,726309,703089
Vermont,2016,M04,3.4,11567,340472,328905
Maine,2002,M09,3.8,25805,678478,652673
Kansas,2008,M01,4.6,67755,1481593,1413838
California,2010,M06,12.0,2206906,18330170,16123264
New York,2012,M07,8.9,869303,9724329,8855026
Georgia,2004,M05,4.5,200423,4426270,4225847
South Carolina,2001,M03,4.6,90186,1953460,1863274
New Jersey,2009,M12,9.5,430107,4525810,4095703
Virginia,2015,M04,4.3,180507,4232878,4052371
West Virginia,2003,M09,5.3,41512,784750,743238
Florida,2009,M03,9.7,881011,9087718,8206707
Oklahoma,2005,M09,4.0,68982,1704637,1635655
Idaho,2014,M03,5.7,44001,773992,729991
Kentucky,2000,M09,3.8,73723,1954173,1880450
Oregon,2011,M08,9.4,188450,2013118,1824668
Arkansas,2015,M10,4.1,54302,1337722,1283420
Indiana,2007,M07,4.6,147068,3229478,3082410
Massachusetts,2006,M11,4.5,155914,3435726,3279812
New Jersey,2004,M02,5.7,245418,4343577,4098159
Pennsylvania,2016,M10,5.2,339080,6461574,6122494
Ohio,2014,M08,5.6,322595,5740780,5418185
Hawaii,2008,M10,5.1,32453,632069,599616
Missouri,2000,M12,4.0,119322,3003682,2884360
New York,2001,M03,4.5,409534,9139343,8729809
Massachusetts,2015,M06,5.2,186885,3624105,3437220
New Mexico,2011,M01,7.9,73576,925783,852207
Michigan,2008,M03,7.6,371951,4921424,4549473
Nevada,2004,M08,4.1,48312,1182705,1134393
Vermont,2006,M06,3.7,13303,361610,348307
Alaska,2015,M03,7.1,25426,359477,334051
Maryland,2010,M06,7.7,238281,3097554,2859273
South Dakota,2005,M10,3.2,13621,431288,417667
Kansas,2005,M04,4.8,70172,1460028,1389856
California,2009,M06,11.3,2060228,18267187,16206959
Indiana,2012,M11,8.0,251879,3166850,2914971
Rhode Island,2008,M10,8.2,46801,569642,522841
Massachusetts,2013,M07,7.0,250860,3564317,3313457
Maine,2012,M07,7.1,51407,719976,668569
Idaho,2005,M04,4.4,32064,724711,692647
Missouri,2003,M06,6.3,194077,3082461,2888384
Wisconsin,2001,M08,4.3,129339,3018765,2889426
New Jersey,2010,M03,10.1,460851,4548793,4087942
Oregon,2002,M06,7.3,133770,1842745,1708975
Florida,2004,M10,4.6,389637,8540067,8150430
Montana,2015,M11,4.1,21102,519023,497921
Alabama,2009,M05,10.6,228776,2164803,1936027
Indiana,2005,M02,6.5,206368,3168844,2962476
Kentucky,2001,M04,4.7,92865,1959304,1866439
Virginia,2004,M10,3.4,128976,3802841,3673865
Iowa,2002,M03,4.5,74094,1635117,1561023
Kansas,2007,M11,4.0,59023,1493335,1434312
Iowa,2015,M09,3.4,57630,1693249,1635619
North Dakota,2002,M08,3.4,11727,347079,335352
North Dakota,2005,M11,2.9,10206,353208,343002
Wisconsin,2013,M08,6.3,196453,3100786,2904333
Virginia,2008,M05,3.7,153915,4147647,3993732
Colorado,2014,M07,4.8,136404,2834854,2698450
Ohio,2004,M05,5.9,343997,5847227,5503230
Delaware,2003,M04,4.4,18058,413261,395203
District of Columbia,2010,M11,9.4,32607,346171,313564
South Dakota,2013,M04,4.0,17574,441678,424104
Texas,2002,M08,6.5,702904,10769939,10067035
Wisconsin,2005,M10,3.9,119000,3028557,2909557
Nevada,2015,M10,6.3,89592,1418667,1329075
Rhode Island,2015,M11,5.3,29200,555200,526000
New Mexico,2016,M08,7.1,66051,928217,862166
Wyoming,2003,M11,4.1,11230,274420,263190
New Hampshire,2015,M09,2.9,21697,738572,716875
Kansas,2015,M12,3.6,53343,1486238,1432895
Montana,2008,M03,5.3,26583,505557,478974
Illinois,2005,M06,6.0,390356,6463524,6073168
Utah,2011,M03,7.5,101464,1346317,1244853
Nevada,2010,M10,13.4,182818,1360418,1177600
Minnesota,2001,M04,3.8,108075,2839131,2731056
Indiana,2010,M09,9.5,300333,3163948,2863615
Nevada,2004,M03,4.6,53766,1164122,1110356
Idaho,2001,M02,5.9,39056,665666,626610
Alabama,2008,M07,6.0,132091,2192307,2060216
Rhode Island,2014,M11,6.5,35915,556398,520483
California,2015,M12,5.6,1053227,18895858,17842631
Wyoming,2007,M05,2.8,7955,284791,276836
Vermont,2010,M02,6.9,24717,358131,333414
California,2014,M10,6.9,1306774,18889506,17582732
Kansas,2016,M02,4.2,62245,1486195,1423950
Iowa,2016,M10,3.2,54397,1702903,1648506
North Dakota,2003,M09,2.9,9912,346674,336762
Rhode Island,2012,M01,12.2,67962,557038,489076
Vermont,2012,M07,5.0,18209,360714,342505
Michigan,2008,M01,7.7,377084,4925364,4548280
Alaska,2008,M01,7.4,25755,349267,323512
Alaska,2010,M07,7.0,26171,372360,346189
Indiana,2006,M02,5.8,185563,3213752,3028189
Michigan,2000,M06,3.8,200618,5225642,5025024
Colorado,2005,M05,4.9,125222,2542720,2417498
Washington,2004,M09,5.4,173593,3193804,3020211
New Jersey,2012,M06,9.6,447801,4647868,4200067
Florida,2014,M08,6.6,638495,9603623,8965128
Minnesota,2004,M04,4.6,133173,2869697,2736524
Indiana,2006,M10,4.3,139601,3243656,3104055
Arizona,2002,M05,5.9,158254,2664223,2505969
Washington,2002,M01,8.3,253601,3038538,2784937
South Carolina,2013,M06,8.3,186534,2236697,2050163
Idaho,2015,M10,3.6,29120,802191,773071
Alaska,2012,M11,6.9,24904,362601,337697
Mississippi,2006,M02,7.5,96694,1286508,1189814
New York,2008,M02,5.4,517695,9556268,9038573
New Jersey,2003,M04,5.7,247875,4329765,4081890
Tennessee,2001,M05,3.6,100820,2837094,2736274
South Carolina,2009,M06,11.9,260682,2193195,1932513
Rhode Island,2015,M02,7.2,39670,549885,510215
Delaware,2001,M09,3.2,13236,416533,403297
Wisconsin,2003,M11,4.9,148831,3045049,2896218
Delaware,2010,M06,8.6,37552,438541,400989
South Dakota,2005,M01,4.6,19391,421452,402061
Arizona,2005,M07,5.0,143566,2896674,2753108
Maine,2013,M10,5.6,39890,709886,669996
California,2000,M11,4.7,799794,16984118,16184324
Missouri,2001,M09,4.3,128896,2974331,2845435
Washington,2016,M03,5.8,210755,3624428,3413673
Texas,2000,M08,4.4,459102,10344547,9885445
Indiana,2010,M06,10.4,332933,3214310,2881377
Utah,2010,M09,7.4,100075,1356031,1255956
Minnesota,2013,M07,4.9,147537,2984700,2837163
Connecticut,2012,M12,7.6,141741,1860329,1718588
Maryland,2004,M09,4.0,114316,2885429,2771113
Maine,2003,M08,4.3,29837,701538,671701
South Carolina,2013,M11,6.5,142009,2179136,2037127
Virginia,2011,M07,6.7,285582,4243953,3958371
Georgia,2016,M05,4.9,241857,4898019,4656162
New Hampshire,2016,M10,2.5,18430,748222,729792
Pennsylvania,2005,M08,4.8,302780,6315510,6012730
Rhode Island,2003,M09,4.8,27119,560289,533170
North Carolina,2000,M08,4.0,167534,4160167,3992633
New York,2003,M05,6.0,555733,9211665,8655932
New Hampshire,2013,M07,4.9,36956,753732,716776
Indiana,2011,M11,8.7,279123,3196800,2917677
South Dakota,2009,M05,4.9,22153,448345,426192
South Carolina,2014,M06,6.6,148265,2252251,2103986
Delaware,2013,M06,7.1,31550,444897,413347
District of Columbia,2013,M08,8.7,32434,372208,339774
Nebraska,2007,M12,2.6,25487,976175,950688
Puerto Rico,2001,M05,11.4,145458,1276895,1131437
Louisiana,2009,M02,6.1,125231,2049231,1924000
New Jersey,2013,M01,9.7,441475,4557315,4115840
Rhode Island,2004,M08,5.2,29116,564563,535447
Indiana,2009,M06,10.8,351270,3252513,2901243
California,2012,M11,9.5,1758087,18573268,16815181
Tennessee,2008,M08,7.0,212699,3059086,2846387
Illinois,2000,M02,4.8,313810,6508472,6194662
Arkansas,2003,M09,5.7,72703,1270472,1197769
Maryland,2003,M04,4.2,121346,2862020,2740674
Arizona,2000,M04,3.6,91043,2500442,2409399
South Carolina,2002,M06,6.1,121434,1981220,1859786
Oregon,2008,M04,5.5,105675,1936051,1830376
Rhode Island,2016,M10,4.7,25753,552117,526364
Louisiana,2008,M01,4.8,98708,2036397,1937689
Louisiana,2007,M12,4.1,83876,2053488,1969612
North Carolina,2016,M09,5.0,243039,4902908,4659869
Michigan,2011,M10,9.4,441705,4693217,4251512
Nevada,2005,M08,4.0,49938,1233178,1183240
New Mexico,2011,M03,7.3,67853,924040,856187
New York,2014,M02,7.5,722329,9582609,8860280
Minnesota,2009,M03,8.5,250738,2939235,2688497
Montana,2014,M06,4.6,24020,520993,496973
West Virginia,2015,M01,7.4,57202,772756,715554
Oklahoma,2009,M01,5.5,95374,1744351,1648977
West Virginia,2005,M08,5.1,40973,798614,757641
Oklahoma,2003,M08,5.4,90178,1682393,1592215
Delaware,2006,M05,3.3,14298,439078,424780
Rhode Island,2013,M03,9.8,53971,552073,498102
Wisconsin,2012,M09,6.1,187539,3066629,2879090
Arkansas,2016,M12,3.8,50559,1327109,1276550
Maine,2008,M10,5.4,37684,702958,665274
Georgia,2014,M05,7.2,342484,4766355,4423871
Connecticut,2012,M04,8.0,151296,1879729,1728433
South Carolina,2011,M01,11.3,243009,2143529,1900520
Kansas,2005,M05,4.9,70891,1460072,1389181
Pennsylvania,2012,M04,7.1,451767,6394825,5943058
Nevada,2003,M11,4.7,54044,1157706,1103662
Idaho,2011,M11,7.9,60309,766701,706392
Montana,2001,M04,4.8,22155,466328,444173
Michigan,2004,M02,7.4,369275,5022116,4652841
South Dakota,2014,M12,3.5,15539,446715,431176
Oregon,2004,M12,6.4,117305,1825227,1707922
Illinois,2010,M03,11.5,762036,6628056,5866020
Arizona,2003,M02,5.8,156224,2707935,2551711
Puerto Rico,2013,M09,15.1,175232,1159823,984591
West Virginia,2009,M01,6.5,52376,803752,751376
Oklahoma,2015,M01,4.4,80229,1811636,1731407
Wyoming,2014,M09,3.6,11051,306169,295118
Wyoming,2003,M05,4.1,11161,272010,260849
Wisconsin,2001,M12,4.8,144004,2999160,2855156
Wyoming,2016,M11,4.6,13967,300414,286447
Kansas,2012,M10,5.3,78977,1490982,1412005
Illinois,2004,M12,5.8,368320,6356559,5988239
District of Columbia,2008,M08,6.5,21930,335318,313388
Wisconsin,2000,M02,4.2,123788,2955214,2831426
Rhode Island,2002,M12,4.8,26753,557309,530556
Kentucky,2000,M01,4.7,92392,1948876,1856484
Rhode Island,2002,M03,5.3,28638,542502,513864
Illinois,2001,M04,5.0,325549,6458591,6133042
Nevada,2003,M01,5.8,65572,1135777,1070205
Alabama,2003,M05,5.6,117632,2107616,1989984
District of Columbia,2003,M07,7.2,22909,316247,293338
Kansas,2004,M04,5.2,75419,1452415,1376996
Kentucky,2006,M01,6.5,129262,1994685,1865423
Massachusetts,2002,M01,5.5,185533,3384335,3198802
New Mexico,2004,M02,5.7,51347,893894,842547
California,2012,M07,10.9,2034354,18617984,16583630
Wyoming,2004,M03,4.3,11830,272540,260710
Ohio,2011,M09,8.6,496411,5780887,5284476
Idaho,2010,M03,10.0,76154,758606,682452
South Dakota,2014,M07,3.0,13739,456122,442383
Pennsylvania,2002,M10,5.1,316571,6203989,5887418
Texas,2009,M09,8.3,1000259,11990437,10990178
West Virginia,2001,M11,4.6,36622,802836,766214
Oklahoma,2007,M11,3.6,63196,1740430,1677234
Rhode Island,2014,M12,6.2,34523,554513,519990
Georgia,2011,M09,10.4,497810,4786174,4288364
Massachusetts,2014,M01,6.8,236802,3502449,3265647
California,2015,M11,5.7,1071735,18909415,17837680
Colorado,2008,M12,5.6,153339,2717966,2564627
Idaho,2003,M08,5.2,36035,692771,656736
Vermont,2010,M04,6.6,23720,356955,333235
Hawaii,2012,M09,5.7,36744,641428,604684
Oregon,2014,M02,8.0,153007,1907328,1754321
Vermont,2002,M06,3.9,13570,347742,334172
Oregon,2014,M10,6.2,120815,1963272,1842457
Alaska,2011,M03,8.4,30468,361503,331035
Colorado,2008,M05,4.3,117290,2696784,2579494
Arkansas,2013,M10,6.7,86583,1299836,1213253
Illinois,2006,M04,4.6,299159,6446410,6147251
Minnesota,2004,M05,4.3,122528,2875171,2752643
Texas,2001,M08,5.4,567122,10490726,9923604
Florida,2016,M06,5.1,497771,9825069,9327298
Montana,2004,M08,4.3,20951,489327,468376
California,2000,M12,4.4,750933,17037419,16286486
New York,2009,M04,7.7,743565,9636542,8892977
Massachusetts,2007,M06,4.8,167837,3473005,3305168
South Carolina,2007,M09,5.6,119816,2128050,2008234
Pennsylvania,2010,M04,8.3,526316,6372262,5845946
Vermont,2014,M06,4.0,14207,352767,338560
Illinois,2009,M02,9.7,636903,6586910,5950007
Maryland,2002,M06,4.7,136312,2896530,2760218
South Dakota,2007,M10,2.4,10472,444282,433810
Oregon,2012,M08,8.7,170303,1961976,1791673
Wisconsin,2008,M04,4.5,138008,3069620,2931612
Missouri,2011,M06,8.8,273113,3086505,2813392
Ohio,2009,M08,10.3,611786,5940580,5328794
Iowa,2013,M01,6.0,99138,1651326,1552188
Idaho,2002,M01,7.0,47541,676100,628559
California,2011,M11,11.0,2040713,18485709,16444996
Massachusetts,2001,M02,3.5,118156,3346943,3228787
Minnesota,2015,M10,3.1,90812,2976009,2885197
Nevada,2006,M01,4.3,53150,1248803,1195653
Arizona,2004,M10,4.7,133633,2822326,2688693
Missouri,2003,M01,5.9,175836,2996741,2820905
New Hampshire,2006,M03,3.7,27016,726775,699759
Missouri,2003,M12,5.1,153224,3004333,2851109
South Dakota,2016,M12,3.1,13748,450700,436952
New Jersey,2015,M03,6.6,297600,4532463,4234863
North Carolina,2003,M12,5.6,236169,4235293,3999124
Massachusetts,2004,M06,5.5,189129,3442204,3253075
Wisconsin,2000,M10,2.8,81897,2968862,2886965
Nevada,2000,M03,4.1,43426,1048364,1004938
Hawaii,2015,M06,4.1,28025,677588,649563
New Mexico,2007,M11,3.5,33036,944309,911273
New Mexico,2004,M11,5.0,46059,914285,868226
Maine,2007,M10,4.3,30068,702858,672790
Massachusetts,2014,M10,5.1,180405,3571584,3391179
South Dakota,2004,M05,3.5,15135,428454,413319
Ohio,2010,M03,11.4,668027,5844397,5176370
Wisconsin,2003,M01,6.4,192926,3032313,2839387
New Jersey,2002,M12,5.6,242224,4339939,4097715
Massachusetts,2006,M03,5.2,174607,3379151,3204544
New Hampshire,2012,M10,5.2,38406,740134,701728
Rhode Island,2014,M07,7.7,43102,562021,518919
Louisiana,2009,M03,6.2,126794,2048550,1921756
Tennessee,2009,M08,10.7,325276,3053062,2727786
South Dakota,2001,M12,3.5,14318,411382,397064
Florida,2013,M08,7.4,705116,9491556,8786440
New York,2009,M12,8.8,830518,9490376,8659858
Mississippi,2000,M11,4.8,63188,1312099,1248911
Alaska,2012,M01,8.2,29740,361338,331598
Virginia,2011,M05,6.4,270624,4221078,3950454
Ohio,2003,M05,6.1,357774,5878439,5520665
Alaska,2010,M09,7.0,25363,363039,337676
Connecticut,2003,M08,5.5,99085,1798297,1699212
Florida,2005,M05,3.5,308750,8707721,8398971
Oregon,2002,M03,8.5,154145,1823165,1669020
Rhode Island,2014,M01,9.9,54902,554817,499915
Michigan,2010,M07,13.5,657000,4868245,4211245
Nebraska,2009,M03,4.7,46517,988768,942251
Alabama,2015,M01,6.4,135842,2134230,1998388
New Jersey,2006,M07,5.3,239097,4520425,4281328
Mississippi,2007,M09,5.9,77108,1308349,1231241
New Jersey,2002,M02,6.0,261910,4348647,4086737
South Dakota,2008,M04,2.8,12255,443706,431451
Tennessee,2010,M04,9.6,297864,3090828,2792964
North Carolina,2004,M09,4.7,197732,4229311,4031579
Massachusetts,2015,M03,5.2,184911,3559162,3374251
Michigan,2008,M06,8.1,402243,4996765,4594522
Massachusetts,2015,M02,5.5,196186,3559931,3363745
Oregon,2000,M10,4.7,85624,1823235,1737611
South Dakota,2016,M04,2.7,12268,450583,438315
Massachusetts,2002,M12,5.2,179764,3424529,3244765
California,2015,M03,6.7,1258970,18858201,17599231
Vermont,2001,M11,3.5,11714,338666,326952
Hawaii,2015,M01,4.1,27732,672291,644559
Maine,2010,M11,7.9,54769,693781,639012
Puerto Rico,2009,M08,16.2,208197,1287101,1078904
Alabama,2010,M07,10.2,225826,2216775,1990949
Pennsylvania,2006,M08,4.8,303485,6363618,6060133
Alabama,2005,M01,5.4,114319,2125538,2011219
South Carolina,2013,M04,7.4,161516,2186150,2024634
Nevada,2003,M12,4.5,52543,1155952,1103409
South Dakota,2003,M07,3.4,14690,433330,418640
Indiana,2013,M04,7.5,237472,3169137,2931665
Hawaii,2007,M10,2.9,18424,631406,612982
New York,2005,M10,4.8,457716,9521873,9064157
North Carolina,2000,M01,3.7,150873,4071913,3921040
South Dakota,2010,M10,4.3,19201,441691,422490
Missouri,2013,M02,7.5,224737,3005867,2781130
South Carolina,2001,M06,5.6,109879,1975931,1866052
Texas,2014,M10,4.6,599382,13039782,12440400
New Jersey,2014,M09,6.5,292735,4502298,4209563
Maryland,2013,M06,7.1,224016,3164699,2940683
Georgia,2004,M04,4.2,185665,4407233,4221568
Washington,2010,M03,10.9,383888,3531360,3147472
Michigan,2002,M09,5.3,266248,4996491,4730243
Pennsylvania,2014,M05,5.9,380713,6414234,6033521
Montana,2008,M12,6.2,31308,503093,471785
Nevada,2001,M09,5.0,56098,1119914,1063816
West Virginia,2004,M02,6.7,51937,780336,728399
Alabama,2001,M11,5.8,124089,2126008,2001919
Oklahoma,2002,M02,4.8,81493,1681824,1600331
Kansas,2015,M05,4.3,63923,1484054,1420131
Michigan,2015,M06,5.9,283112,4811325,4528213
Florida,2006,M12,3.2,290658,9138448,8847790
North Carolina,2006,M01,4.8,205540,4315126,4109586
District of Columbia,2006,M02,5.9,18396,313570,295174
Colorado,2003,M09,5.6,140887,2503681,2362794
California,2006,M03,5.2,908219,17551382,16643163
Tennessee,2009,M04,10.2,310985,3053594,2742609
Vermont,2010,M03,7.0,25221,359203,333982
Michigan,2014,M12,5.6,261815,4714386,4452571
South Carolina,2006,M06,6.8,145432,2131875,1986443
Mississippi,2006,M10,5.9,76066,1294000,1217934
Oregon,2012,M04,8.9,173740,1958599,1784859
North Dakota,2016,M05,2.9,12292,417037,404745
Rhode Island,2010,M10,10.6,60015,565253,505238
Delaware,2004,M04,3.9,16167,419320,403153
Illinois,2014,M06,7.1,465801,6578716,6112915
Michigan,2007,M08,6.9,346637,5016782,4670145
Colorado,2007,M01,4.3,111984,2628074,2516090
Michigan,2016,M08,5.2,254249,4874284,4620035
New Mexico,2007,M03,3.7,34579,927576,892997
Rhode Island,2009,M10,10.6,59667,565524,505857
Oregon,2005,M10,5.4,100524,1856432,1755908
Ohio,2016,M09,4.9,281698,5719701,5438003
Montana,2010,M06,7.2,36649,507974,471325
Virginia,2006,M10,2.7,110011,4000897,3890886
Tennessee,2005,M12,5.1,150828,2955578,2804750
New Mexico,2002,M09,5.3,46149,876228,830079
Louisiana,2008,M12,5.5,115151,2087369,1972218
North Carolina,2007,M08,4.7,212508,4511679,4299171
Texas,2010,M11,8.1,1001853,12364508,11362655
Pennsylvania,2013,M12,6.1,386338,6348682,5962344
Puerto Rico,2009,M02,14.4,190022,1320900,1130878
South Carolina,2001,M01,4.6,90844,1954392,1863548
Maine,2004,M02,5.6,38055,674412,636357
Arkansas,2000,M10,3.5,44017,1249961,1205944
Kentucky,2004,M08,4.9,96805,1960133,1863328
Maryland,2003,M12,4.1,116915,2873413,2756498
New Hampshire,2012,M05,5.3,38992,735088,696096
Indiana,2015,M04,4.5,145431,3249563,3104132
South Carolina,2014,M08,7.3,164576,2254924,2090348
Missouri,2010,M02,10.5,318362,3032198,2713836
Virginia,2011,M06,6.9,290037,4228490,3938453
Maryland,2016,M04,4.0,126511,3143001,3016490
Ohio,2008,M08,6.8,410768,6035115,5624347
Oregon,2010,M08,10.2,205431,2006181,1800750
New Hampshire,2015,M07,3.3,24633,756088,731455
Tennessee,2014,M09,6.4,194786,3036500,2841714
Missouri,2003,M11,5.2,156514,3015310,2858796
Vermont,2006,M11,3.5,12600,356469,343869
Washington,2011,M09,8.7,301575,3459828,3158253
Alabama,2014,M10,6.0,130881,2166226,2035345
New Jersey,2014,M11,6.2,281281,4530331,4249050
District of Columbia,2004,M02,7.3,22420,307910,285490
Minnesota,2011,M09,5.9,172657,2950735,2778078
Louisiana,2004,M12,5.5,111896,2042928,1931032
Rhode Island,2006,M03,5.5,30971,566611,535640
Nebraska,2008,M11,3.3,32870,991184,958314
Florida,2008,M04,4.8,443154,9170544,8727390
Indiana,2011,M03,9.2,289264,3146796,2857532
Minnesota,2010,M05,7.0,206306,2938287,2731981
Washington,2002,M10,6.6,204335,3106835,2902500
Virginia,2000,M09,2.1,75826,3580861,3505035
West Virginia,2010,M07,8.3,68140,816453,748313
Oklahoma,2012,M07,5.4,97037,1813697,1716660
California,2008,M10,8.0,1461880,18325183,16863303
Georgia,2011,M01,10.8,509108,4698498,4189390
Kansas,2010,M10,6.7,100038,1498548,1398510
Maryland,2004,M04,3.9,112813,2858638,2745825
Iowa,2007,M03,4.2,68650,1650660,1582010
Pennsylvania,2006,M09,4.1,260914,6293253,6032339
Pennsylvania,2013,M07,7.8,513419,6548894,6035475
West Virginia,2009,M05,8.0,65189,819274,754085
Oklahoma,2015,M05,4.6,84181,1838168,1753987
Texas,2013,M05,6.2,797952,12892427,12094475
North Carolina,2001,M05,5.0,211210,4203034,3991824
Kentucky,2002,M01,6.6,127560,1930121,1802561
Pennsylvania,2003,M03,6.1,373742,6139651,5765909
California,2007,M05,4.8,846097,17768341,16922244
North Dakota,2004,M06,3.7,13334,361673,348339
Delaware,2007,M03,3.7,16449,442155,425706
Georgia,2012,M12,8.7,417812,4797035,4379223
Massachusetts,2014,M11,5.1,181167,3577986,3396819
Montana,2000,M09,4.2,19460,466306,446846
Vermont,2010,M11,5.7,20296,358487,338191
District of Columbia,2007,M08,5.5,17901,322874,304973
District of Columbia,2014,M04,7.2,26644,371057,344413
Maryland,2011,M02,7.6,234179,3066164,2831985
Maine,2006,M02,5.4,36910,689195,652285
Virginia,2011,M04,6.2,258678,4202767,3944089
Maryland,2016,M06,4.5,142976,3190270,3047294
Nebraska,2012,M11,3.5,35562,1017295,981733
Indiana,2002,M03,5.8,182371,3148251,2965880
Nebraska,2015,M11,2.7,27000,1007482,980482
Idaho,2016,M12,3.5,28961,816378,787417
Alaska,2000,M02,7.5,23708,315722,292014
Missouri,2008,M07,6.5,198975,3067237,2868262
Oregon,2015,M08,5.6,113127,2005657,1892530
Montana,2011,M01,8.6,42374,494840,452466
Missouri,2002,M02,5.8,174796,2995531,2820735
North Carolina,2005,M08,5.1,223333,4346586,4123253
Pennsylvania,2004,M10,4.9,307890,6226324,5918434
Vermont,2002,M09,3.8,12899,343455,330556
New Jersey,2005,M12,4.6,203218,4425434,4222216
Florida,2013,M12,6.3,593159,9407766,8814607
Kansas,2008,M09,4.7,70994,1501114,1430120
North Dakota,2007,M06,3.4,12970,376656,363686
Kentucky,2015,M11,5.0,98006,1970610,1872604
South Carolina,2000,M08,4.2,83866,2008078,1924212
Oregon,2004,M07,7.2,134159,1858506,1724347
Florida,2013,M02,7.6,710978,9363466,8652488
New York,2002,M12,6.3,579910,9277188,8697278
Wisconsin,2012,M04,7.0,214344,3050793,2836449
Nebraska,2000,M01,3.2,30203,932678,902475
Missouri,2015,M06,5.3,164733,3137037,2972304
Louisiana,2003,M11,5.6,113686,2022921,1909235
Puerto Rico,2008,M03,9.3,125768,1346571,1220803
Texas,2010,M08,8.2,1011330,12285979,11274649
Alabama,2001,M12,5.8,124127,2122949,1998822
Rhode Island,2007,M11,5.2,29967,573689,543722
Nevada,2016,M03,6.1,86979,1422063,1335084
Maryland,2006,M04,3.6,105378,2934783,2829405
Minnesota,2010,M01,8.5,248166,2908573,2660407
Georgia,2010,M07,10.7,500134,4693367,4193233
Kansas,2007,M12,4.1,61453,1487782,1426329
Montana,2009,M06,6.7,34267,508369,474102
Delaware,2015,M10,4.6,21871,470898,449027
Maine,2010,M05,8.1,55618,689737,634119
North Carolina,2010,M02,12.0,549878,4578175,4028297
Arizona,2005,M02,4.7,134289,2830812,2696523
District of Columbia,2012,M10,8.7,32514,372520,340006
Indiana,2000,M11,2.7,84510,3109371,3024861
Kentucky,2008,M12,7.9,161817,2043155,1881338
Vermont,2013,M02,4.9,17320,350348,333028
Ohio,2004,M12,6.0,352246,5858307,5506061
South Dakota,2009,M04,5.2,23336,446138,422802
Georgia,2013,M05,8.2,391258,4783397,4392139
North Dakota,2010,M07,3.6,13806,387339,373533
Utah,2016,M07,3.6,54440,1524943,1470503
Arkansas,2008,M01,5.7,77387,1350256,1272869
Wyoming,2015,M12,4.8,14459,300859,286400
Pennsylvania,2006,M12,4.0,252842,6319377,6066535
Arkansas,2012,M10,7.0,92787,1328684,1235897
Massachusetts,2013,M12,6.0,209163,3505439,3296276
Kansas,2002,M03,5.2,73449,1399232,1325783
Wisconsin,2010,M02,10.4,321571,3077511,2755940
New York,2008,M12,6.5,630096,9673860,9043764
Ohio,2006,M03,5.5,323822,5869806,5545984
Puerto Rico,2014,M02,14.6,168255,1153124,984869
Indiana,2003,M02,5.6,177058,3164114,2987056
Minnesota,2016,M02,4.5,135154,2987047,2851893
Virginia,2013,M04,5.3,222330,4233218,4010888
Iowa,2015,M01,4.9,82592,1699063,1616471
Vermont,2002,M07,3.8,13387,348384,334997
New Jersey,2011,M06,9.5,436072,4598582,4162510
Iowa,2006,M05,3.3,54194,1652298,1598104
Tennessee,2005,M02,6.4,183235,2857953,2674718
New Jersey,2005,M04,4.0,175983,4349379,4173396
Mississippi,2009,M10,10.0,125705,1257049,1131344
Virginia,2007,M02,3.2,128940,3991132,3862192
Colorado,2015,M11,3.4,95464,2838133,2742669
Nevada,2006,M05,3.9,49639,1278197,1228558
Missouri,2004,M02,6.0,180501,3005380,2824879
New York,2000,M06,4.3,395389,9198085,8802696
Texas,2004,M03,6.2,682846,10946853,10264007
Mississippi,2003,M02,6.6,84547,1288076,1203529
Pennsylvania,2001,M02,5.0,305912,6138553,5832641
Nebraska,2003,M07,4.2,41351,980100,938749
South Dakota,2016,M06,2.8,12784,461502,448718
Colorado,2013,M02,7.8,216607,2766871,2550264
Delaware,2004,M05,3.5,14699,418126,403427
Alabama,2005,M09,4.3,91681,2148855,2057174
Hawaii,2001,M03,4.0,24297,611797,587500
Oregon,2006,M03,6.0,110653,1856506,1745853
Alabama,2000,M05,4.1,86308,2124095,2037787
Puerto Rico,2016,M11,11.0,121705,1111068,989363
Nebraska,2013,M03,4.1,41341,1015120,973779
Iowa,2006,M04,3.5,58077,1649177,1591100
South Dakota,2012,M04,4.3,18879,440421,421542
Puerto Rico,2010,M07,17.3,217224,1258594,1041370
Vermont,2001,M08,3.1,10427,341401,330974
Ohio,2015,M03,5.2,296597,5657654,5361057
Massachusetts,2009,M04,7.3,253103,3446723,3193620
Massachusetts,2003,M03,5.9,201206,3411218,3210012
Michigan,2012,M06,9.8,462289,4736626,4274337
Illinois,2011,M09,9.8,646609,6611300,5964691
Maryland,2008,M01,3.6,107023,2960332,2853309
Kentucky,2005,M07,6.1,123222,2020057,1896835
Michigan,2013,M01,10.0,467307,4679541,4212234
Missouri,2004,M08,6.2,186553,3015664,2829111
New Jersey,2008,M06,5.1,231250,4544256,4313006
Hawaii,2008,M06,4.7,30428,647745,617317
Tennessee,2002,M08,4.8,139227,2908820,2769593
Pennsylvania,2015,M05,5.5,355027,6472656,6117629
Alaska,2002,M12,7.7,25103,325912,300809
Maine,2001,M09,3.5,23474,676191,652717
Nebraska,2016,M02,3.4,33976,1004058,970082
Florida,2010,M08,11.5,1069651,9316229,8246578
Connecticut,2010,M07,9.3,182201,1949252,1767051
California,2011,M03,12.1,2215482,18353713,16138231
North Carolina,2008,M02,5.3,236310,4493285,4256975
Kansas,2003,M04,5.0,71963,1425620,1353657
Arizona,2011,M07,10.4,316488,3037565,2721077
Arizona,2015,M10,5.9,186750,3188024,3001274
Rhode Island,2001,M07,5.0,27329,550536,523207
Nebraska,2008,M12,3.7,36836,987857,951021
Colorado,2012,M11,7.3,200982,2760633,2559651
Connecticut,2008,M09,6.0,112297,1882477,1770180
Nebraska,2007,M10,2.8,27353,982987,955634
North Dakota,2016,M07,2.9,12420,424877,412457
Connecticut,2013,M05,7.8,146119,1872792,1726673
Washington,2005,M01,6.4,206640,3214346,3007706
West Virginia,2000,M09,4.8,39090,808993,769903
Oklahoma,2006,M09,3.9,66383,1714759,1648376
Kentucky,2003,M09,5.7,112022,1958449,1846427
Delaware,2007,M11,3.2,14230,445988,431758
Michigan,2011,M01,11.5,535400,4650140,4114740
Florida,2005,M01,4.3,362923,8504159,8141236
Missouri,2006,M04,4.4,132899,3012959,2880060
Maryland,2008,M10,4.8,144562,3024312,2879750
Kansas,2015,M02,4.6,67769,1486547,1418778
South Dakota,2005,M11,3.3,14027,430166,416139
Indiana,2000,M07,3.3,102308,3146465,3044157
Wisconsin,2004,M02,6.3,191971,3041664,2849693
Washington,2004,M01,7.7,243426,3160931,2917505
Kentucky,2001,M07,5.2,102729,1971497,1868768
Rhode Island,2009,M05,11.0,62053,563515,501462
Kansas,2000,M12,3.3,45849,1391253,1345404
Connecticut,2016,M07,5.4,103538,1924769,1821231
Michigan,2003,M06,8.0,411194,5116577,4705383
Arizona,2010,M05,10.0,310530,3091206,2780676
South Dakota,2000,M01,3.1,12305,400908,388603
Nebraska,2003,M09,3.7,35467,956137,920670
Arizona,2011,M09,9.7,294074,3044055,2749981
Indiana,2003,M11,5.0,160054,3177181,3017127
Minnesota,2016,M11,3.4,102107,2997906,2895799
Vermont,2005,M06,3.4,12201,353730,341529
Florida,2003,M01,5.5,445592,8111784,7666192
Maryland,2005,M06,4.5,132321,2952204,2819883
California,2002,M03,6.9,1193760,17262754,16068994
Arizona,2014,M03,6.9,210809,3075747,2864938
Puerto Rico,2002,M08,13.1,173878,1323199,1149321
Maine,2011,M07,7.4,53225,716797,663572
Missouri,2000,M06,3.4,100885,2992148,2891263
Pennsylvania,2001,M08,4.9,306938,6216858,5909920
Idaho,2011,M09,7.4,56416,765693,709277
Colorado,2015,M02,4.7,131216,2818781,2687565
Oregon,2016,M12,4.2,85717,2052822,1967105
North Carolina,2004,M08,5.2,220284,4256273,4035989
Connecticut,2002,M03,3.8,66839,1750549,1683710
Michigan,2016,M01,5.1,241886,4751237,4509351
Kentucky,2014,M02,8.4,169990,2026893,1856903
Indiana,2011,M10,8.9,286568,3212939,2926371
Kentucky,2013,M03,8.4,174328,2064677,1890349
Delaware,2009,M06,8.6,38079,443332,405253
New York,2016,M07,5.0,487956,9696799,9208843
Nebraska,2003,M11,3.5,33946,964381,930435
Arizona,2001,M05,4.1,105634,2557225,2451591
Louisiana,2015,M12,5.4,114227,2119466,2005239
Rhode Island,2012,M11,9.4,52889,560667,507778
Louisiana,2002,M02,5.8,114288,1980907,1866619
Rhode Island,2008,M08,8.2,47381,575701,528320
New Hampshire,2000,M09,2.4,16662,686214,669552
Mississippi,2014,M01,8.7,108317,1243560,1135243
Kansas,2012,M12,5.2,77894,1485957,1408063
North Carolina,2015,M07,6.3,302495,4805532,4503037
Georgia,2002,M10,4.8,207652,4356750,4149098
New Hampshire,2005,M05,3.4,24395,721085,696690
Wyoming,2006,M12,2.9,8165,281986,273821
District of Columbia,2008,M04,5.2,17089,326763,309674
Indiana,2008,M08,6.2,200408,3258356,3057948
Mississippi,2008,M07,7.5,98605,1322551,1223946
Indiana,2015,M11,4.5,148566,3296843,3148277
Massachusetts,2002,M09,5.4,186306,3432249,3245943
Florida,2004,M08,4.8,406810,8499503,8092693
Illinois,2006,M06,4.7,308797,6590088,6281291
Mississippi,2010,M03,10.8,135423,1258381,1122958
Nevada,2001,M08,5.0,56337,1117995,1061658
Maine,2000,M01,4.5,30156,671914,641758
Arkansas,2004,M05,5.8,75314,1298453,1223139
North Dakota,2002,M10,2.9,9756,340290,330534
Rhode Island,2007,M10,5.0,28783,571964,543181
Oregon,2012,M12,8.5,162735,1911498,1748763
Connecticut,2009,M03,7.5,140916,1872369,1731453
Indiana,2016,M07,4.4,147172,3360615,3213443
Minnesota,2003,M07,4.9,143065,2909647,2766582
Minnesota,2006,M04,4.0,113863,2873704,2759841
Kentucky,2002,M03,6.2,120432,1945845,1825413
Arkansas,2006,M10,4.5,61972,1363857,1301885
District of Columbia,2000,M09,5.9,18330,310729,292399
New Hampshire,2009,M01,5.9,43588,744247,700659
Kentucky,2015,M10,4.7,91893,1956237,1864344
North Dakota,2000,M09,2.2,7391,342288,334897
Wyoming,2015,M01,4.6,13961,302808,288847
West Virginia,2008,M12,4.7,37823,803663,765840
Michigan,2015,M02,6.1,286191,4723210,4437019
Oklahoma,2014,M12,3.9,69730,1808007,1738277
Georgia,2009,M02,9.5,453867,4784917,4331050
Connecticut,2014,M10,6.1,114716,1892422,1777706
West Virginia,2005,M04,5.1,40165,785847,745682
Kentucky,2009,M06,11.0,230548,2102091,1871543
Oklahoma,2003,M04,5.1,85122,1680919,1595797
Louisiana,2013,M10,6.1,127991,2110930,1982939
North Carolina,2014,M05,6.4,302712,4714271,4411559
Ohio,2012,M07,7.8,448871,5776909,5328038
New Hampshire,2008,M01,4.1,30281,739736,709455
South Dakota,2001,M09,2.8,11687,411110,399423
Montana,2010,M08,6.5,33335,508961,475626
New Hampshire,2014,M10,3.6,26823,738064,711241
South Dakota,2004,M03,4.2,17988,423284,405296
Illinois,2015,M10,5.6,367218,6522819,6155601
California,2003,M09,6.5,1123298,17232054,16108756
Iowa,2003,M10,4.0,63840,1605169,1541329
District of Columbia,2004,M08,8.2,25830,315478,289648
Maine,2012,M04,8.0,55309,694576,639267
Kentucky,2012,M02,9.0,184478,2042589,1858111
Colorado,2002,M05,5.2,125672,2422388,2296716
Alabama,2012,M10,7.5,165164,2190278,2025114
Oregon,2011,M04,9.5,188043,1987782,1799739
New Mexico,2010,M07,8.8,83399,948303,864904
Arkansas,2008,M06,5.4,74806,1397451,1322645
Wyoming,2006,M04,3.2,8885,277729,268844
Washington,2000,M10,4.6,140914,3047418,2906504
Louisiana,2000,M02,4.8,97530,2021125,1923595
Delaware,2016,M02,4.8,22590,471486,448896
Delaware,2003,M03,4.8,19771,413043,393272
Vermont,2006,M10,3.1,11004,357680,346676
Georgia,2007,M10,4.7,229201,4845124,4615923
Connecticut,2003,M02,5.8,102928,1774333,1671405
Kentucky,2006,M06,5.9,121645,2057441,1935796
Kansas,2011,M07,6.8,102765,1509256,1406491
Delaware,2014,M09,5.5,24941,452943,428002
District of Columbia,2010,M04,8.7,29934,344365,314431
Colorado,2000,M12,2.5,59926,2367690,2307764
Missouri,2014,M09,5.6,170402,3058740,2888338
Kentucky,2003,M12,5.3,103992,1960695,1856703
Ohio,2011,M12,7.7,442197,5710918,5268721
Indiana,2014,M03,6.6,212638,3206151,2993513
New Jersey,2016,M03,5.4,245237,4539380,4294143
Missouri,2015,M05,5.2,164207,3128650,2964443
Maryland,2007,M09,3.3,99045,2972196,2873151
Iowa,2000,M07,2.3,36279,1602741,1566462
Alaska,2015,M07,5.8,21718,373613,351895
Wyoming,2014,M01,5.2,15920,304065,288145
Wisconsin,2000,M05,3.3,98105,2951103,2852998
Kentucky,2015,M01,6.0,117837,1960292,1842455
Nebraska,2008,M02,3.4,33371,980653,947282
Arkansas,2015,M06,5.4,72894,1351984,1279090
North Dakota,2003,M11,3.2,10932,344544,333612
Puerto Rico,2006,M10,9.8,137981,1411301,1273320
Florida,2009,M09,11.1,1010453,9095377,8084924
North Carolina,2008,M12,8.7,400586,4590845,4190259
North Carolina,2003,M10,5.9,252490,4268003,4015513
West Virginia,2014,M07,6.5,51968,795817,743849
Oklahoma,2008,M07,3.7,65842,1763453,1697611
Connecticut,2004,M08,4.9,88456,1791013,1702557
Hawaii,2003,M07,4.4,26648,609441,582793
South Carolina,2013,M05,7.7,169316,2208569,2039253
Wyoming,2010,M01,8.1,24303,299388,275085
Rhode Island,2007,M04,4.7,26991,568708,541717
Texas,2000,M10,3.9,401938,10388801,9986863
South Dakota,2014,M05,3.3,14717,448741,434024
Montana,2013,M01,6.8,34132,505427,471295
Idaho,2000,M10,4.0,26450,663772,637322
Georgia,2001,M04,3.6,153931,4250050,4096119
Massachusetts,2007,M01,5.6,190865,3410072,3219207
Puerto Rico,2004,M03,11.7,159033,1356858,1197825
Utah,2001,M02,4.3,49631,1152995,1103364
California,2000,M05,4.8,800370,16769803,15969433
California,2003,M11,6.7,1154660,17336680,16182020
Tennessee,2011,M05,8.9,277568,3128403,2850835
Rhode Island,2013,M10,8.7,48693,558234,509541
Kansas,2008,M11,4.8,72282,1513025,1440743
Pennsylvania,2014,M04,5.4,343896,6349006,6005110
Georgia,2011,M12,9.7,464985,4794042,4329057
New York,2012,M03,8.9,849589,9566682,8717093
Michigan,2011,M03,11.0,513231,4671442,4158211
Arizona,2014,M07,7.3,227380,3101503,2874123
Nevada,2005,M11,3.9,47926,1243645,1195719
Minnesota,2014,M01,5.5,161146,2946021,2784875
Montana,2005,M06,4.5,22115,492610,470495
Oregon,2000,M08,5.2,96270,1841333,1745063
Colorado,2002,M10,5.2,129459,2466976,2337517
Virginia,2009,M10,6.8,279679,4086254,3806575
Iowa,2007,M05,3.3,54944,1651489,1596545
Arizona,2013,M05,7.6,229166,3027720,2798554
Colorado,2008,M07,5.0,136285,2747469,2611184
Wisconsin,2002,M08,5.0,151525,3040954,2889429
Kentucky,2004,M02,6.5,126039,1948185,1822146
Wisconsin,2011,M07,7.8,244498,3117197,2872699
Iowa,2002,M09,3.6,59077,1638587,1579510
Arizona,2002,M11,5.9,158503,2703600,2545097
Iowa,2015,M03,4.2,71653,1700255,1628602
Tennessee,2010,M10,9.0,277832,3104056,2826224
Nevada,2009,M05,10.8,145865,1348106,1202241
Minnesota,2008,M01,5.5,159701,2889445,2729744
Kansas,2006,M03,4.6,67710,1456183,1388473
Alaska,2005,M12,7.1,24332,343111,318779
Pennsylvania,2015,M07,5.9,384320,6526434,6142114
Hawaii,2006,M08,2.5,15851,640114,624263
Tennessee,2001,M09,4.5,129818,2853268,2723450
Rhode Island,2000,M07,4.4,24293,550670,526377
Ohio,2015,M01,6.1,343904,5654257,5310353
Illinois,2011,M07,10.4,691164,6676628,5985464
Ohio,2013,M10,7.2,412490,5720030,5307540
Puerto Rico,2015,M03,12.5,142282,1135946,993664
North Dakota,2016,M03,4.1,16909,411486,394577
Arkansas,2005,M01,6.1,79530,1300443,1220913
Indiana,2010,M04,10.6,337846,3194892,2857046
Puerto Rico,2010,M09,16.5,208826,1265550,1056724
Kansas,2012,M11,5.1,75755,1489686,1413931
District of Columbia,2003,M12,6.6,19963,303499,283536
Minnesota,2014,M07,4.0,121181,2992542,2871361
Kansas,2011,M11,5.7,85574,1490657,1405083
Iowa,2005,M08,3.9,64295,1633392,1569097
Oregon,2006,M01,6.3,115318,1841927,1726609
Puerto Rico,2011,M05,16.3,198651,1217185,1018534
Indiana,2015,M09,4.1,134789,3260898,3126109
Montana,2013,M03,6.3,31900,507880,475980
Alabama,2006,M12,3.7,82045,2189793,2107748
Montana,2006,M10,2.7,13496,491149,477653
Tennessee,2015,M06,6.2,192525,3108995,2916470
Alabama,2007,M10,3.8,82043,2181178,2099135
Connecticut,2013,M04,7.6,141444,1852498,1711054
New Jersey,2012,M02,9.7,444627,4568971,4124344
Tennessee,2005,M08,5.3,156167,2921487,2765320
New Jersey,2003,M06,6.2,273248,4393443,4120195
Puerto Rico,2012,M06,14.2,169662,1198532,1028870
Rhode Island,2009,M04,11.1,62617,564240,501623
Georgia,2006,M07,5.2,247280,4742466,4495186
Colorado,2007,M12,4.0,106291,2688236,2581945
Virginia,2013,M12,5.1,215576,4206163,3990587
Georgia,2003,M04,4.8,209068,4383895,4174827
New York,2008,M06,5.1,495640,9734450,9238810
Florida,2011,M04,9.7,900377,9260364,8359987
West Virginia,2004,M11,4.5,35089,780699,745610
Alabama,2001,M02,5.0,105469,2115373,2009904
Oklahoma,2002,M11,4.7,80062,1686901,1606839
Florida,2006,M10,3.2,290815,9119796,8828981
Hawaii,2012,M06,6.8,44161,650385,606224
Texas,2014,M01,5.7,740348,12915103,12174755
Massachusetts,2010,M12,7.6,264352,3465594,3201242
North Dakota,2014,M07,2.5,10470,424981,414511
Alaska,2001,M10,5.9,18762,320224,301462
Oregon,2016,M08,5.1,107054,2085823,1978769
Tennessee,2015,M03,5.7,174262,3046402,2872140
Wyoming,2008,M10,2.7,8123,295880,287757
Texas,2009,M06,8.5,1022430,12041241,11018811
Maine,2002,M11,4.5,30301,675064,644763
California,2002,M01,7.0,1200966,17142642,15941676
South Carolina,2009,M02,11.0,236254,2148353,1912099
Idaho,2010,M04,9.4,71342,761063,689721
Rhode Island,2010,M05,11.2,62895,563832,500937
Washington,2016,M04,5.3,190589,3613072,3422483
Tennessee,2004,M01,5.8,167541,2874010,2706469
New Jersey,2000,M06,3.5,151534,4321466,4169932
Puerto Rico,2015,M06,12.6,140095,1110564,970469
Wyoming,2005,M02,4.0,10774,271173,260399
Texas,2010,M09,8.0,982925,12316442,11333517
Puerto Rico,2005,M08,11.2,156534,1394525,1237991
Vermont,2010,M07,5.9,21479,364714,343235
Georgia,2012,M09,8.7,417163,4786810,4369647
Montana,2000,M12,4.8,22302,460047,437745
Colorado,2011,M12,8.1,222259,2750109,2527850
Alabama,2009,M11,11.1,238550,2148876,1910326
New York,2015,M06,5.2,506257,9675449,9169192
Hawaii,2011,M09,7.1,46277,655121,608844
Ohio,2008,M10,6.5,390440,5980503,5590063
Kansas,2002,M05,4.7,66336,1402449,1336113
Mississippi,2009,M01,8.7,111537,1276166,1164629
South Dakota,2004,M02,4.1,17383,420396,403013
West Virginia,2008,M08,3.9,31980,812898,780918
Rhode Island,2015,M12,5.1,28357,552912,524555
Oklahoma,2014,M08,4.4,77993,1785942,1707949
New Mexico,2005,M02,5.5,50253,908752,858499
Iowa,2014,M01,5.3,90082,1685037,1594955
Florida,2007,M01,3.6,329698,9078520,8748822
Arizona,2016,M01,5.6,178545,3197977,3019432
Delaware,2009,M11,8.3,35491,430151,394660
Arizona,2002,M03,5.9,156449,2655816,2499367
Indiana,2016,M05,4.2,140717,3342323,3201606
Nebraska,2003,M06,4.3,41841,978031,936190
Minnesota,2003,M05,4.4,127356,2869962,2742606
Missouri,2004,M06,6.2,189563,3058091,2868528
Connecticut,2015,M04,5.7,106836,1881421,1774585
Maine,2001,M11,4.0,26612,671086,644474
Hawaii,2008,M08,4.5,28936,640711,611775
Michigan,2011,M06,11.2,529518,4739995,4210477
Georgia,2003,M12,4.0,174968,4412264,4237296
Delaware,2012,M01,7.6,33892,444140,410248
Massachusetts,2010,M07,8.3,294190,3525744,3231554
Nebraska,2016,M10,3.0,30561,1011427,980866
Minnesota,2000,M02,3.7,101454,2773305,2671851
District of Columbia,2011,M05,10.1,35172,347122,311950
Ohio,2000,M02,4.7,272305,5755268,5482963
Alabama,2007,M02,4.2,91769,2170069,2078300
West Virginia,2000,M06,5.6,45831,821728,775897
Oklahoma,2006,M06,4.3,74332,1737921,1663589
Alabama,2005,M11,4.0,86786,2165655,2078869
Wyoming,2013,M10,4.2,12765,306560,293795
Massachusetts,2016,M10,2.8,101927,3576746,3474819
New York,2011,M08,8.2,786711,9571346,8784635
Indiana,2009,M10,10.2,321740,3163110,2841370
Rhode Island,2001,M06,4.5,24535,546918,522383
Idaho,2004,M04,5.2,35930,693468,657538
Pennsylvania,2003,M01,6.5,403456,6161022,5757566
Louisiana,2010,M03,7.3,151114,2057986,1906872
Rhode Island,2016,M06,5.1,28574,556175,527601
Wyoming,2007,M02,3.2,9056,280755,271699
Missouri,2009,M07,9.7,299211,3096929,2797718
Connecticut,2013,M03,8.2,151761,1854240,1702479
Iowa,2011,M11,5.0,82031,1655024,1572993
Delaware,2013,M10,6.1,27203,442475,415272
Alabama,2014,M12,5.7,121281,2144708,2023427
Minnesota,2002,M04,4.9,139902,2856747,2716845
Kentucky,2006,M03,6.2,126204,2019295,1893091
North Dakota,2001,M02,3.6,12197,339471,327274
Maine,2015,M07,4.0,27769,699205,671436
New Mexico,2006,M02,4.3,39131,919577,880446
Wisconsin,2009,M09,8.1,250089,3076468,2826379
Oregon,2001,M08,6.5,119995,1839345,1719350
Connecticut,2015,M12,5.2,97111,1881638,1784527
Virginia,2015,M06,4.7,198515,4248608,4050093
West Virginia,2001,M04,5.2,42016,812428,770412
New Mexico,2011,M05,7.1,65710,923950,858240
Kentucky,2005,M06,6.2,126327,2032340,1906013
Oklahoma,2007,M04,3.9,67540,1716669,1649129
Georgia,2008,M11,7.3,348210,4769721,4421511
Ohio,2004,M08,6.0,353761,5918777,5565016
Ohio,2014,M11,4.9,282794,5717016,5434222
Colorado,2011,M05,8.4,228940,2721618,2492678
Rhode Island,2013,M02,10.1,55792,553830,498038
Alaska,2005,M09,6.0,20936,346062,325126
Connecticut,2010,M06,9.1,175187,1931026,1755839
California,2010,M04,12.0,2201236,18357644,16156408
Utah,2005,M01,4.7,58355,1243984,1185629
Oregon,2011,M11,8.9,177412,1994158,1816746
Virginia,2008,M04,3.2,131364,4124861,3993497
Wyoming,2011,M09,5.0,15281,307206,291925
Idaho,2015,M12,4.1,33062,800220,767158
Idaho,2000,M02,5.8,37563,650668,613105
Nevada,2016,M01,6.6,93218,1415888,1322670
New Mexico,2008,M06,4.9,46969,951797,904828
Vermont,2004,M04,4.1,14196,343774,329578
North Dakota,2008,M08,3.0,11374,378302,366928
Maine,2008,M04,5.3,37054,696604,659550
Connecticut,2012,M10,8.1,151398,1880150,1728752
Florida,2006,M05,3.0,267733,8968901,8701168
Mississippi,2011,M10,9.8,132384,1344508,1212124
Kansas,2013,M01,6.1,90721,1482829,1392108
Louisiana,2004,M09,5.7,114564,2027273,1912709
Mississippi,2000,M09,4.8,63166,1304214,1241048
Louisiana,2011,M10,7.5,157272,2085996,1928724
Washington,2015,M02,6.3,223488,3524088,3300600
Massachusetts,2004,M05,5.1,171047,3374639,3203592
South Carolina,2015,M07,6.1,139916,2297396,2157480
Connecticut,2007,M09,4.4,81627,1856385,1774758
New Jersey,2001,M07,4.4,189854,4344617,4154763
North Carolina,2007,M09,4.5,201890,4523810,4321920
Florida,2001,M07,4.6,372619,8112520,7739901
District of Columbia,2009,M10,10.1,34201,337518,303317
California,2010,M05,11.7,2140341,18318838,16178497
New Mexico,2012,M10,6.8,63267,936212,872945
Georgia,2004,M12,5.1,232679,4522059,4289380
Wisconsin,2008,M11,5.2,161215,3095403,2934188
Arizona,2002,M06,6.5,175161,2687948,2512787
Tennessee,2014,M12,5.8,176442,3037181,2860739
Kentucky,2002,M06,5.8,113680,1970082,1856402
Nevada,2006,M11,3.9,50433,1306995,1256562
Montana,2016,M07,3.8,20466,537115,516649
Connecticut,2009,M06,8.0,152472,1910173,1757701
Arkansas,2000,M06,4.4,56574,1285773,1229199
Texas,2016,M01,4.5,591497,13112957,12521460
Alabama,2005,M07,4.7,100411,2153124,2052713
Nebraska,2004,M11,3.5,33954,970476,936522
Tennessee,2011,M04,9.0,279731,3121085,2841354
Oregon,2007,M09,4.6,88811,1930510,1841699
Rhode Island,2006,M05,4.8,27266,567987,540721
Nebraska,2007,M11,2.9,28266,984191,955925
Missouri,2013,M12,6.1,184224,3003567,2819343
New Mexico,2015,M06,7.3,67924,931126,863202
Connecticut,2007,M07,4.8,89866,1890609,1800743
Nebraska,2012,M09,3.7,36906,1009407,972501
New Jersey,2009,M09,9.5,428629,4518694,4090065
Nevada,2003,M10,4.7,53918,1155266,1101348
Maine,2004,M05,4.4,29547,678677,649130
Kentucky,2014,M06,6.7,136425,2036331,1899906
New Jersey,2004,M05,4.7,203022,4328520,4125498
Idaho,2009,M06,9.1,70624,772517,701893
Ohio,2014,M09,5.2,295940,5695279,5399339
Nevada,2009,M07,11.7,157934,1352925,1194991
New Jersey,2012,M10,8.9,408120,4593560,4185440
Arizona,2013,M04,7.4,223349,3019931,2796582
Nevada,2014,M09,7.5,104999,1398955,1293956
Alabama,2006,M11,3.7,80347,2185680,2105333
South Dakota,2007,M05,2.7,11873,442958,431085
Pennsylvania,2013,M05,7.3,472231,6474288,6002057
Nebraska,2005,M10,3.3,32571,972331,939760
Maine,2000,M03,4.2,27949,673180,645231
Kentucky,2007,M11,4.7,95644,2027592,1931948
Colorado,2005,M03,5.6,141485,2533734,2392249
Georgia,2014,M01,7.4,349691,4720353,4370662
Florida,2016,M02,4.7,460727,9734040,9273313
Oregon,2003,M01,8.6,156545,1829432,1672887
Arizona,2013,M06,8.2,251554,3051207,2799653
Colorado,2000,M09,2.6,60406,2364744,2304338
Puerto Rico,2016,M01,11.2,125139,1122044,996905
North Dakota,2013,M02,3.7,14779,399695,384916
Louisiana,2011,M11,6.9,143762,2071611,1927849
Georgia,2005,M04,5.1,233468,4546996,4313528
Arkansas,2007,M06,5.6,77580,1390961,1313381
Puerto Rico,2011,M07,16.5,200208,1211782,1011574
Alabama,2009,M12,11.4,242992,2137965,1894973
North Dakota,2003,M06,4.0,14206,352986,338780
Wyoming,2004,M05,3.6,9699,273197,263498
New York,2008,M03,5.2,493552,9572922,9079370
District of Columbia,2015,M05,6.5,24832,381569,356737
Oregon,2005,M01,7.2,131578,1817933,1686355
Alaska,2004,M03,8.5,28065,330776,302711
New Mexico,2001,M11,4.8,41826,865325,823499
South Carolina,2010,M09,10.7,231578,2155564,1923986
Tennessee,2012,M04,7.3,223613,3078159,2854546
Kentucky,2000,M12,4.0,79282,1971182,1891900
Texas,2014,M08,5.4,695628,12994387,12298759
Ohio,2012,M12,7.3,414895,5686606,5271711
New Jersey,2003,M03,6.2,267402,4332485,4065083
Alabama,2002,M11,5.8,122932,2126034,2003102
Montana,2003,M08,4.3,20551,480195,459644
South Carolina,2011,M10,10.3,225551,2181308,1955757
Missouri,2014,M08,6.2,188824,3050570,2861746
Alabama,2014,M02,7.9,170822,2165104,1994282
Iowa,2011,M03,6.1,101860,1668314,1566454
Missouri,2012,M05,6.7,201832,3034112,2832280
Nebraska,2006,M08,3.0,29031,972763,943732
Montana,2013,M06,5.5,28480,519620,491140
Florida,2015,M03,5.4,515163,9569169,9054006
Delaware,2006,M11,2.9,12988,442720,429732
Georgia,2015,M02,6.3,300869,4765360,4464491
Indiana,2001,M07,4.1,129473,3158317,3028844
New York,2000,M12,4.1,371369,9135940,8764571
Colorado,2004,M10,5.0,127493,2554011,2426518
New Hampshire,2003,M02,4.8,33705,698547,664842
Washington,2007,M06,4.5,154763,3415482,3260719
Nevada,2008,M11,8.2,111588,1365874,1254286
Connecticut,2016,M02,6.0,113325,1880764,1767439
Hawaii,2016,M09,3.1,21042,685456,664414
Arizona,2001,M08,5.6,144425,2583063,2438638
New York,2007,M03,4.4,414052,9471835,9057783
New Mexico,2009,M01,6.5,60778,938975,878197
Maine,2004,M10,4.2,28987,691634,662647
Rhode Island,2004,M02,6.0,33015,554710,521695
Maine,2010,M07,7.8,55261,710394,655133
Nebraska,2014,M01,4.0,39790,1005810,966020
Massachusetts,2005,M07,4.9,166819,3434216,3267397
New Jersey,2008,M03,5.0,224857,4478557,4253700
Tennessee,2008,M05,6.1,185915,3052115,2866200
Kansas,2012,M05,5.6,82479,1477148,1394669
Nevada,2015,M03,7.0,98901,1407681,1308780
Hawaii,2016,M07,3.1,21439,689706,668267
Iowa,2004,M03,5.0,79373,1593547,1514174
Louisiana,2005,M04,5.1,105883,2057989,1952106
Georgia,2015,M11,5.4,258379,4805473,4547094
North Carolina,2013,M11,6.9,323431,4670147,4346716
North Dakota,2015,M02,3.4,13912,411639,397727
Ohio,2006,M04,5.3,314381,5895231,5580850
Tennessee,2007,M06,4.5,140474,3092649,2952175
Virginia,2003,M09,4.0,147551,3728591,3581040
Utah,2014,M10,3.5,50818,1442537,1391719
Minnesota,2009,M05,7.6,223803,2948090,2724287
Wisconsin,2007,M07,4.9,153749,3135103,2981354
Arkansas,2011,M01,9.5,126996,1343694,1216698
Hawaii,2015,M10,3.3,22144,673826,651682
Puerto Rico,2004,M06,10.3,139610,1357869,1218259
Montana,2005,M07,4.0,19753,497068,477315
Pennsylvania,2005,M09,4.5,282305,6250640,5968335
Maine,2009,M04,8.5,59134,691813,632679
Tennessee,2011,M03,9.5,296761,3122667,2825906
Idaho,2012,M07,6.8,52681,779185,726504
California,2006,M01,5.3,931417,17486991,16555574
Michigan,2006,M08,7.0,358086,5103387,4745301
Colorado,2004,M11,5.2,133247,2546063,2412816
New York,2009,M09,8.6,823544,9587617,8764073
New Hampshire,2012,M06,5.5,40942,748579,707637
Puerto Rico,2012,M01,15.5,189585,1219603,1030018
Oregon,2011,M12,9.1,179652,1978254,1798602
Delaware,2011,M08,7.5,33466,446506,413040
Alabama,2012,M02,8.4,182555,2165383,1982828
Montana,2003,M09,4.1,19306,471851,452545
Nevada,2014,M08,7.7,107773,1396927,1289154
South Dakota,2013,M11,3.5,15499,446099,430600
Georgia,2013,M02,8.7,413285,4765878,4352593
Nevada,2006,M03,4.1,51573,1265282,1213709
Illinois,2015,M02,6.5,417743,6448679,6030936
Alaska,2007,M01,7.3,25129,345579,320450
Mississippi,2015,M11,5.9,75592,1281335,1205743
North Dakota,2005,M04,3.5,12283,352715,340432
New Jersey,2009,M08,9.3,427069,4583022,4155953
California,2012,M01,11.4,2094925,18375806,16280881
Alabama,2000,M07,4.9,103561,2132923,2029362
Puerto Rico,2001,M10,12.7,161560,1277008,1115448
New Mexico,2006,M10,3.8,35694,934616,898922
Louisiana,2001,M11,5.9,119845,2016496,1896651
Wyoming,2003,M04,4.5,12179,270977,258798
Puerto Rico,2006,M01,11.0,156823,1422224,1265401
Puerto Rico,2007,M06,12.0,166750,1389577,1222827
New York,2005,M02,5.7,537258,9372598,8835340
Georgia,2016,M03,5.3,260822,4894135,4633313
Vermont,2001,M09,3.1,10541,337638,327097
New Hampshire,2011,M06,5.4,39707,742078,702371
Hawaii,2013,M04,4.7,30218,645223,615005
Kansas,2011,M09,6.2,92874,1487732,1394858
Kentucky,2012,M11,7.4,152687,2060697,1908010
Oregon,2016,M06,5.3,109759,2074431,1964672
Maryland,2015,M08,5.1,160828,3163596,3002768
Arkansas,2008,M03,5.0,68336,1367948,1299612
Michigan,2007,M09,6.8,337190,4993030,4655840
Alaska,2002,M07,6.6,22293,336508,314215
Oregon,2007,M12,5.2,99755,1928900,1829145
Rhode Island,2002,M04,4.7,25692,542733,517041
Connecticut,2008,M12,6.1,114489,1877485,1762996
Florida,2012,M07,9.1,858598,9441462,8582864
Ohio,2004,M04,6.1,354501,5831648,5477147
Missouri,2015,M03,5.8,178804,3090929,2912125
Louisiana,2000,M11,5.4,110704,2037122,1926418
Missouri,2012,M06,7.0,215208,3061351,2846143
Maryland,2006,M03,3.7,107120,2933482,2826362
Hawaii,2012,M07,6.1,39484,650179,610695
Kansas,2004,M12,4.9,71247,1464216,1392969
North Carolina,2005,M10,4.8,210923,4362581,4151658
District of Columbia,2002,M08,6.3,19446,307954,288508
Delaware,2010,M01,9.3,40001,428070,388069
Texas,2009,M07,8.6,1035741,12076569,11040828
New York,2006,M01,5.1,484298,9441643,8957345
Florida,2008,M11,7.6,698579,9210743,8512164
Indiana,2007,M11,4.3,137384,3219201,3081817
Puerto Rico,2013,M12,15.4,180453,1173314,992861
Nebraska,2013,M04,3.8,38907,1019624,980717
Nebraska,2003,M12,3.6,34867,960670,925803
Montana,2014,M05,4.2,21524,513422,491898
West Virginia,2008,M06,4.3,35676,823470,787794
South Carolina,2015,M05,6.1,138364,2287002,2148638
Oklahoma,2014,M06,4.8,86547,1800630,1714083
South Dakota,2007,M01,3.6,15344,431598,416254
Missouri,2001,M11,4.8,142272,2977745,2835473
Rhode Island,2012,M12,9.2,51242,558640,507398
Tennessee,2014,M08,7.0,213679,3041428,2827749
Texas,2016,M05,4.3,566379,13245519,12679140
Delaware,2006,M03,3.9,17029,439288,422259
Louisiana,2016,M11,5.4,114387,2104428,1990041
Colorado,2008,M04,4.2,112894,2696159,2583265
Rhode Island,2009,M06,10.9,61892,570089,508197
Alabama,2016,M07,6.1,132734,2173465,2040731
Colorado,2016,M12,2.7,78247,2892195,2813948
Virginia,2013,M07,5.9,254213,4292550,4038337
New Mexico,2007,M09,3.6,33268,933311,900043
West Virginia,2000,M12,5.1,40850,807357,766507
Oklahoma,2006,M12,4.0,68323,1725123,1656800
New Mexico,2002,M03,5.5,47829,864020,816191
Montana,2015,M10,3.8,19535,520227,500692
California,2006,M12,4.7,835543,17809241,16973698
Maine,2016,M10,3.4,23884,697727,673843
Florida,2012,M02,8.7,810363,9275856,8465493
Tennessee,2008,M10,6.9,210282,3064120,2853838
Iowa,2003,M12,4.5,71999,1595247,1523248
New Hampshire,2005,M07,3.4,25462,740340,714878
Montana,2002,M08,3.7,17320,473794,456474
West Virginia,2011,M06,8.1,65669,814505,748836
Colorado,2014,M11,4.1,116124,2815154,2699030
Nevada,2010,M04,13.4,182115,1357060,1174945
Virginia,2012,M04,5.6,237833,4212020,3974187
Maryland,2007,M11,3.1,93018,2975245,2882227
Oklahoma,2013,M06,5.7,104751,1829417,1724666
Nebraska,2012,M07,4.3,44237,1032121,987884
Utah,2006,M01,3.8,48494,1291220,1242726
Hawaii,2004,M11,3.3,20222,617089,596867
Kentucky,2013,M06,8.6,180161,2095155,1914994
South Dakota,2010,M12,5.1,22540,438173,415633
Oregon,2007,M07,5.1,99062,1938052,1838990
Rhode Island,2006,M06,4.8,27717,576300,548583
Alaska,2001,M02,7.4,23402,316271,292869
Connecticut,2002,M06,4.4,79789,1793306,1713517
Illinois,2004,M09,5.7,357067,6299271,5942204
Alabama,2001,M10,5.6,118727,2124978,2006251
Minnesota,2014,M09,3.5,103462,2953266,2849804
Virginia,2012,M05,6.0,256067,4243939,3987872
Ohio,2003,M11,5.6,330788,5859838,5529050
California,2010,M12,12.1,2212970,18329776,16116806
Ohio,2010,M05,9.9,580776,5861820,5281044
Rhode Island,2011,M03,11.5,64108,557121,493013
Idaho,2015,M04,4.3,34115,789781,755666
Illinois,2012,M07,9.6,641233,6688508,6047275
Montana,2009,M11,6.7,33342,496177,462835
District of Columbia,2015,M10,6.6,25891,389678,363787
Florida,2000,M10,3.6,285306,7903688,7618382
Hawaii,2015,M11,3.2,22004,679298,657294
Arkansas,2007,M05,5.3,72401,1372446,1300045
Kentucky,2010,M06,10.0,208474,2075997,1867523
Michigan,2009,M11,13.1,636937,4854795,4217858
Virginia,2005,M01,3.9,149609,3800512,3650903
Michigan,2014,M11,5.8,273436,4744426,4470990
Utah,2010,M04,7.8,105724,1351858,1246134
New Jersey,2010,M11,9.2,418187,4538572,4120385
Connecticut,2001,M06,3.4,60999,1779434,1718435
District of Columbia,2012,M11,8.6,32272,373462,341190
West Virginia,2009,M10,7.6,61765,814200,752435
Oklahoma,2015,M10,4.4,80611,1842869,1762258
Arizona,2008,M09,7.2,226257,3137880,2911623
Delaware,2002,M02,4.5,18930,418369,399439
Indiana,2012,M01,9.2,290986,3159809,2868823
Idaho,2001,M06,4.6,31651,687495,655844
Minnesota,2004,M03,5.7,164832,2869206,2704374
California,2013,M04,8.7,1616169,18541493,16925324
Arkansas,2011,M06,8.6,118752,1376690,1257938
Kentucky,2013,M01,8.9,182825,2053579,1870754
Idaho,2004,M09,4.1,29066,705178,676112
Minnesota,2007,M04,4.6,134021,2896633,2762612
Vermont,2014,M05,3.7,12816,346122,333306
Georgia,2011,M06,10.8,512454,4751514,4239060
Delaware,2007,M05,3.0,13219,440868,427649
Arizona,2005,M06,4.9,141748,2889093,2747345
Alaska,2000,M03,7.2,22604,315725,293121
North Carolina,2009,M02,10.7,491633,4582170,4090537
Iowa,2008,M05,3.6,59543,1672348,1612805
Delaware,2006,M04,3.5,15580,439621,424041
District of Columbia,2012,M02,9.9,35270,356876,321606
West Virginia,2006,M10,4.3,35077,812641,777564
Arizona,2006,M05,4.0,119619,2962140,2842521
South Dakota,2016,M03,3.2,14162,449225,435063
Oklahoma,2000,M10,2.9,47698,1665648,1617950
Missouri,2015,M10,4.0,124287,3089597,2965310
Mississippi,2013,M02,9.1,117107,1280234,1163127
Massachusetts,2000,M01,3.6,121431,3329916,3208485
Maine,2005,M03,5.7,38667,682808,644141
Nevada,2008,M04,5.8,78770,1360849,1282079
Maryland,2003,M10,4.1,119197,2882968,2763771
South Dakota,2012,M07,4.0,18254,450855,432601
Massachusetts,2005,M09,4.9,165476,3370978,3205502
Hawaii,2014,M08,4.2,28019,667432,639413
Missouri,2010,M10,9.0,274341,3051759,2777418
New Jersey,2013,M10,7.6,338028,4470911,4132883
Hawaii,2003,M05,4.0,24021,601612,577591
South Carolina,2013,M07,7.9,176263,2227585,2051322
Wisconsin,2006,M08,4.5,137862,3085726,2947864
New Jersey,2011,M02,9.9,451609,4541084,4089475
Montana,2010,M05,6.8,34223,501472,467249
Georgia,2003,M08,4.9,214659,4386761,4172102
Arkansas,2000,M02,5.0,62946,1255563,1192617
Texas,2007,M01,4.7,536436,11365485,10829049
Kansas,2004,M11,5.1,74710,1472450,1397740
District of Columbia,2011,M12,9.7,33969,350607,316638
Kansas,2003,M11,5.4,78281,1449048,1370767
New Mexico,2013,M01,7.3,67816,925485,857669
Arkansas,2007,M08,5.2,71817,1370746,1298929
Alaska,2009,M03,8.3,29333,355085,325752
Arkansas,2016,M08,3.9,52969,1345036,1292067
Washington,2015,M06,5.4,192713,3558147,3365434
Wisconsin,2002,M01,6.1,181876,2986843,2804967
Puerto Rico,2004,M05,10.8,144819,1341139,1196320
District of Columbia,2003,M09,6.8,20942,306204,285262
New Jersey,2004,M03,5.6,242557,4347196,4104639
West Virginia,2011,M12,7.3,58843,801402,742559
Oklahoma,2013,M12,4.9,88565,1790236,1701671
Wyoming,2000,M04,3.9,10164,263603,253439
Rhode Island,2011,M11,10.9,61483,562291,500808
Michigan,2005,M08,6.2,317395,5118496,4801101
Missouri,2012,M01,7.6,227747,3000505,2772758
South Dakota,2006,M09,2.9,12435,434824,422389
California,2015,M04,6.2,1161275,18852520,17691245
Maine,2006,M10,4.1,28874,707222,678348
Ohio,2003,M03,6.7,394713,5857794,5463081
Ohio,2011,M07,9.4,547106,5843565,5296459
California,2012,M09,9.6,1784926,18568080,16783154
Utah,2002,M05,5.7,67573,1178913,1111340
Puerto Rico,2008,M06,12.1,163357,1354519,1191162
Connecticut,2008,M08,6.2,117252,1903576,1786324
California,2009,M05,10.6,1931991,18192576,16260585
Alaska,2016,M01,7.3,25900,356376,330476
Alabama,2014,M08,7.1,153829,2161076,2007247
Alabama,2008,M09,5.9,127509,2169953,2042444
Montana,2007,M02,3.7,18172,491171,472999
Illinois,2015,M05,5.7,373676,6517229,6143553
Utah,2012,M10,4.9,67806,1386511,1318705
California,2004,M07,6.4,1126663,17491733,16365070
Nevada,2002,M03,6.0,67462,1124349,1056887
North Carolina,2012,M07,9.9,465525,4713622,4248097
North Dakota,2001,M04,3.1,10483,342158,331675
Colorado,2003,M12,5.7,141521,2499028,2357507
New Hampshire,2004,M06,3.7,26997,723099,696102
Mississippi,2015,M07,6.9,88486,1288816,1200330
Maine,2004,M09,4.1,28350,687628,659278
Arkansas,2006,M02,5.5,75080,1356458,1281378
Maryland,2012,M08,7.1,222806,3135511,2912705
Montana,2014,M11,4.5,22765,510385,487620
Wyoming,2007,M04,3.0,8390,282916,274526
New Jersey,2015,M10,4.9,221189,4506849,4285660
Puerto Rico,2010,M01,16.0,207181,1291699,1084518
Massachusetts,2004,M03,5.7,192381,3389502,3197121
Puerto Rico,2011,M06,15.4,188473,1224970,1036497
Vermont,2005,M02,4.1,14275,346747,332472
Rhode Island,2007,M12,5.6,32056,572226,540170
Arkansas,2011,M05,8.3,113396,1363357,1249961
Michigan,2003,M02,7.4,372434,5000266,4627832
Colorado,2009,M04,6.8,185081,2719605,2534524
Maryland,2005,M04,4.0,114725,2894273,2779548
West Virginia,2005,M09,4.7,37899,799418,761519
Oklahoma,2003,M09,5.3,89173,1678317,1589144
Arizona,2014,M04,6.3,192544,3064021,2871477
Connecticut,2008,M03,5.3,98409,1862227,1763818
Oregon,2000,M02,5.9,105636,1805218,1699582
Wisconsin,2012,M08,6.9,211912,3084960,2873048
Hawaii,2009,M04,7.1,44703,633809,589106
Florida,2010,M09,11.1,1036129,9328747,8292618
Utah,2006,M06,3.3,44074,1326521,1282447
North Dakota,2004,M03,4.2,14700,347231,332531
Ohio,2003,M08,6.0,354378,5905807,5551429
North Carolina,2015,M04,5.4,259350,4760514,4501164
Colorado,2006,M02,4.9,125893,2582769,2456876
Ohio,2000,M04,3.7,213024,5762880,5549856
Missouri,2011,M03,9.2,279004,3047366,2768362
Puerto Rico,2005,M04,11.4,153175,1346166,1192991
New Hampshire,2003,M06,4.3,30876,714512,683636
Maryland,2002,M03,4.6,132241,2859096,2726855
Vermont,2010,M05,5.9,21199,357232,336033
North Dakota,2016,M02,4.0,16456,409691,393235
Arkansas,2016,M03,4.0,54291,1343609,1289318
Alaska,2009,M08,6.9,25174,366043,340869
Rhode Island,2013,M12,8.7,48474,557722,509248
Nevada,2012,M12,10.4,142637,1375637,1233000
Tennessee,2000,M11,3.9,111150,2844499,2733349
California,2013,M03,9.3,1731830,18552493,16820663
Iowa,2001,M09,3.0,49259,1615296,1566037
California,2001,M10,5.8,1003763,17202729,16198966
West Virginia,2012,M06,7.7,63259,821842,758583
Maryland,2004,M07,4.5,131278,2945124,2813846
Oklahoma,2010,M06,7.0,126163,1790313,1664150
New Mexico,2003,M02,5.8,50754,880342,829588
New Hampshire,2004,M01,4.7,33631,708614,674983
New Mexico,2000,M04,4.7,39033,838912,799879
Louisiana,2001,M05,5.2,105023,2027278,1922255
North Carolina,2003,M08,6.5,275920,4251476,3975556
Florida,2011,M08,10.3,961702,9337996,8376294
New Hampshire,2011,M08,5.4,39997,744703,704706
Michigan,2002,M12,6.1,306836,4990767,4683931
Massachusetts,2010,M05,8.2,284514,3466965,3182451
New Hampshire,2013,M09,4.7,34803,737273,702470
Hawaii,2007,M05,2.5,16011,638430,622419
Idaho,2008,M04,5.1,38183,753940,715757
Illinois,2011,M04,9.1,590912,6528344,5937432
Kentucky,2013,M05,8.1,168127,2075880,1907753
Rhode Island,2003,M07,5.6,31933,568746,536813
Florida,2009,M04,9.5,867867,9100085,8232218
Wyoming,2005,M04,3.5,9672,273022,263350
Texas,2014,M05,5.0,656576,13015614,12359038
West Virginia,2003,M12,5.2,40184,777284,737100
Oklahoma,2005,M12,4.1,69859,1709946,1640087
New York,2000,M04,4.3,396178,9109625,8713447
Delaware,2011,M01,8.5,37352,438457,401105
District of Columbia,2000,M12,5.7,17984,313720,295736
South Dakota,2014,M06,3.2,14799,455718,440919
Connecticut,2002,M05,4.1,72366,1772246,1699880
Oregon,2001,M02,6.3,113969,1811830,1697861
Indiana,2008,M09,5.7,185331,3231248,3045917
Wisconsin,2003,M05,5.5,168229,3037775,2869546
North Carolina,2004,M01,6.3,266128,4233780,3967652
Puerto Rico,2008,M05,11.6,157269,1356494,1199225
Pennsylvania,2016,M01,5.6,362723,6425448,6062725
Tennessee,2012,M06,8.5,266527,3143920,2877393
West Virginia,2015,M06,7.2,57608,799077,741469
Oklahoma,2009,M06,6.8,121145,1792640,1671495
Utah,2007,M07,2.8,38650,1373167,1334517
Oregon,2005,M08,6.0,111259,1869336,1758077
Minnesota,2012,M11,4.7,140062,2951038,2810976
Virginia,2006,M01,3.3,130103,3902608,3772505
Wisconsin,2002,M10,4.4,133992,3032270,2898278
Delaware,2001,M07,3.3,14244,425917,411673
Delaware,2002,M08,4.0,16504,417471,400967
Hawaii,2004,M07,3.3,20621,617287,596666
North Dakota,2005,M09,2.7,9670,356318,346648
New Hampshire,2006,M04,3.3,23653,724380,700727
Texas,2011,M07,8.3,1039997,12541172,11501175
Pennsylvania,2000,M08,4.2,260652,6161123,5900471
New Mexico,2004,M06,6.2,56188,907840,851652
Vermont,2000,M04,3.0,9732,326341,316609
Idaho,2015,M11,4.1,32638,799760,767122
South Dakota,2009,M06,4.9,22384,455028,432644
Massachusetts,2006,M02,5.4,183196,3371984,3188788
New York,2003,M02,6.9,636658,9289358,8652700
Rhode Island,2014,M06,7.3,40724,557940,517216
Rhode Island,2015,M03,6.9,38109,549524,511415
Massachusetts,2011,M12,6.6,227241,3466240,3238999
Illinois,2008,M01,6.0,403592,6674782,6271190
Kentucky,2008,M07,6.5,133906,2051302,1917396
West Virginia,2016,M03,6.9,53243,776928,723685
Colorado,2011,M07,8.1,221884,2744150,2522266
New York,2003,M04,6.1,564253,9234773,8670520
South Carolina,2007,M01,6.5,136253,2109853,1973600
Michigan,2001,M07,5.5,283569,5168886,4885317
Alaska,2014,M11,6.5,23452,361195,337743
District of Columbia,2011,M08,10.5,36842,351650,314808
Nevada,2007,M07,4.6,61758,1336109,1274351
Wyoming,2005,M12,3.5,9808,276753,266945
Vermont,2011,M10,4.8,17120,357360,340240
Maine,2009,M05,8.3,57246,692923,635677
Vermont,2009,M07,6.6,23998,364741,340743
Delaware,2003,M09,4.1,16972,411980,395008
New Mexico,2011,M06,8.1,76016,937543,861527
Utah,2016,M04,3.5,52210,1495938,1443728
Arkansas,2015,M02,6.1,80060,1316130,1236070
California,2013,M11,8.3,1541085,18618845,17077760
Delaware,2014,M03,6.2,27758,447463,419705
Missouri,2003,M09,5.6,168632,3004374,2835742
Kansas,2014,M01,5.2,76545,1484442,1407897
Utah,2008,M09,3.4,46188,1372063,1325875
Virginia,2001,M10,3.8,137806,3668149,3530343
New York,2015,M12,4.7,452588,9551737,9099149
Alabama,2000,M04,3.8,80215,2125386,2045171
Maryland,2010,M09,7.4,229886,3086048,2856162
Montana,2016,M05,3.7,19465,526760,507295
Montana,2002,M03,5.5,25323,463180,437857
Massachusetts,2007,M12,4.4,151274,3423771,3272497
Nebraska,2011,M05,4.3,43192,1004549,961357
Indiana,2009,M03,10.7,343739,3208107,2864368
Georgia,2007,M06,4.7,226592,4810578,4583986
Pennsylvania,2015,M04,4.9,313275,6393205,6079930
Oregon,2012,M05,8.4,164586,1953882,1789296
Rhode Island,2001,M09,4.3,23195,543712,520517
Maine,2005,M01,5.6,38372,680346,641974
New Mexico,2009,M11,7.5,70284,937965,867681
New Mexico,2014,M11,6.3,58267,930291,872024
Nevada,2004,M12,4.0,48270,1192988,1144718
Pennsylvania,2011,M07,8.5,551111,6477082,5925971
Tennessee,2016,M06,5.2,166315,3168941,3002626
Connecticut,2010,M04,8.9,168356,1897909,1729553
Alabama,2010,M11,10.0,222536,2224017,2001481
New Hampshire,2016,M03,3.2,23501,744820,721319
Kentucky,2010,M08,9.8,200511,2048013,1847502
Washington,2015,M05,5.5,196518,3545409,3348891
Massachusetts,2004,M02,5.8,195853,3389640,3193787
New Jersey,2014,M04,6.3,281567,4475281,4193714
Alaska,2015,M02,7.3,26386,359707,333321
Nebraska,2008,M04,3.0,29207,988061,958854
Tennessee,2014,M03,6.8,207403,3035676,2828273
Arkansas,2001,M09,4.6,58171,1253435,1195264
Puerto Rico,2003,M03,12.1,163756,1351500,1187744
Louisiana,2009,M06,7.8,163364,2099902,1936538
Arizona,2001,M11,5.3,138119,2624175,2486056
Illinois,2001,M05,4.7,303436,6444431,6140995
Nebraska,2010,M08,4.4,43586,996507,952921
Missouri,2006,M12,4.6,141507,3049562,2908055
Rhode Island,2016,M04,5.1,27892,547325,519433
Hawaii,2011,M10,6.9,45430,654059,608629
Michigan,2011,M05,10.5,494221,4699821,4205600
Kansas,2009,M10,6.9,104235,1514217,1409982
Alabama,2010,M06,10.5,234972,2229562,1994590
Hawaii,2015,M03,3.8,25441,672192,646751
Washington,2016,M11,5.1,188004,3671129,3483125
New Mexico,2010,M11,7.6,71582,936847,865265
Nevada,2000,M06,4.1,44146,1066845,1022699
Texas,2010,M10,7.8,963964,12314250,11350286
Arizona,2005,M08,5.0,144363,2908603,2764240
Wisconsin,2014,M09,4.6,141494,3088257,2946763
Arkansas,2013,M02,8.1,105211,1306802,1201591
Arizona,2013,M10,7.7,234151,3041378,2807227
Connecticut,2014,M05,6.6,124549,1884657,1760108
Minnesota,2010,M10,6.6,193574,2943214,2749640
Georgia,2007,M11,4.6,222616,4875673,4653057
Illinois,2000,M10,3.8,244235,6448611,6204376
Alaska,2016,M11,6.4,23006,356778,333772
Wisconsin,2007,M01,5.5,169799,3060928,2891129
Arkansas,2011,M07,8.7,120548,1380259,1259711
New Mexico,2004,M05,5.3,47261,894065,846804
Washington,2011,M04,9.1,314715,3446853,3132138
Puerto Rico,2015,M09,12.2,136521,1122296,985775
Mississippi,2006,M11,5.9,77083,1298749,1221666
Nebraska,2002,M01,4.1,38491,940394,901903
South Carolina,2015,M12,5.4,122137,2267022,2144885
Montana,2015,M01,5.3,26949,511385,484436
Wyoming,2008,M09,2.5,7503,294561,287058
Puerto Rico,2010,M03,16.3,207028,1272675,1065647
New York,2016,M04,4.6,439358,9576980,9137622
Alaska,2007,M05,6.2,21858,350961,329103
Arizona,2005,M11,4.5,130761,2930028,2799267
Arizona,2006,M11,3.8,116017,3040101,2924084
Louisiana,2007,M09,4.1,84469,2036560,1952091
District of Columbia,2008,M05,5.8,18846,327551,308705
New Hampshire,2005,M04,3.5,25197,717879,692682
Nevada,2002,M01,6.7,75170,1120170,1045000
Wyoming,2000,M12,3.9,10373,266669,256296
Nevada,2003,M06,5.4,61573,1147146,1085573
California,2008,M02,6.3,1138022,17992713,16854691
Nebraska,2004,M01,4.5,42948,958027,915079
Texas,2006,M02,5.3,593738,11217411,10623673
Idaho,2002,M08,4.9,33814,688706,654892
Montana,2013,M05,4.9,25270,512455,487185
New Hampshire,2000,M02,3.2,21530,678815,657285
Nevada,2015,M04,7.0,98549,1412033,1313484
Ohio,2009,M01,9.6,566975,5890159,5323184
Tennessee,2006,M08,5.5,167424,3070120,2902696
New Mexico,2009,M07,8.4,80064,950214,870150
Maine,2013,M04,7.2,50744,700836,650092
Oregon,2001,M10,6.7,122406,1831433,1709027
Mississippi,2007,M11,5.3,69801,1318682,1248881
Wisconsin,2015,M08,4.2,130628,3109477,2978849
New York,2004,M02,6.8,631794,9254128,8622334
Puerto Rico,2000,M02,10.5,135846,1298434,1162588
New Mexico,2005,M08,5.1,46864,921126,874262
Oregon,2004,M09,6.4,118006,1834581,1716575
Maine,2013,M02,8.2,56981,696999,640018
South Carolina,2003,M12,6.7,133811,1990188,1856377
Kansas,2008,M07,4.9,75170,1522608,1447438
North Dakota,2004,M01,4.4,15081,343665,328584
Mississippi,2013,M03,8.4,107180,1271037,1163857
Washington,2008,M04,4.7,160935,3446477,3285542
Ohio,2013,M09,7.2,412950,5726540,5313590
Missouri,2012,M12,6.6,198833,3012225,2813392
New Jersey,2005,M08,4.2,184983,4438330,4253347
Illinois,2005,M03,6.0,376994,6320406,5943412
New York,2008,M10,5.6,547381,9727841,9180460
Idaho,2010,M06,8.5,65265,769293,704028
Vermont,2001,M10,2.8,9652,338791,329139
Puerto Rico,2007,M01,10.2,144510,1419946,1275436
Delaware,2000,M10,3.5,14721,416472,401751
Ohio,2002,M10,5.1,298680,5864990,5566310
Florida,2006,M06,3.4,305331,9030077,8724746
Puerto Rico,2003,M06,12.7,175041,1375216,1200175
Georgia,2009,M09,10.3,494303,4779963,4285660
Oregon,2015,M12,4.9,98945,2007644,1908699
Utah,2013,M05,4.5,63520,1403194,1339674
Louisiana,2002,M04,5.7,113301,1994629,1881328
Hawaii,2014,M09,4.3,28621,664678,636057
Iowa,2004,M08,4.4,70163,1603016,1532853
Georgia,2004,M06,5.3,238030,4455807,4217777
Arizona,2002,M12,5.7,153937,2701986,2548049
West Virginia,2012,M05,7.3,59680,813413,753733
Oklahoma,2010,M05,6.8,121062,1771810,1650748
Alaska,2009,M01,8.0,28281,353287,325006
Puerto Rico,2001,M04,11.2,142170,1266367,1124197
Puerto Rico,2006,M08,10.9,152996,1403733,1250737
Oregon,2016,M01,5.3,105493,2003414,1897921
Utah,2014,M06,4.1,58880,1436018,1377138
Puerto Rico,2011,M01,15.9,199193,1252120,1052927
Puerto Rico,2008,M07,12.4,166567,1339648,1173081
Puerto Rico,2001,M01,10.4,131222,1260661,1129439
California,2013,M12,8.0,1485483,18543178,17057695
Oregon,2008,M05,5.3,102998,1935011,1832013
Louisiana,2002,M05,5.9,118097,2002709,1884612
South Carolina,2005,M09,6.9,144265,2081140,1936875
California,2009,M03,10.9,1991432,18249212,16257780
Arizona,2001,M03,4.1,105944,2564948,2459004
Hawaii,2004,M05,3.2,19593,608371,588778
South Carolina,2012,M07,9.8,216722,2220976,2004254
California,2014,M02,8.4,1564923,18687025,17122102
Rhode Island,2016,M02,6.2,34090,549472,515382
Oregon,2010,M01,11.9,231746,1955080,1723334
Illinois,2012,M02,9.6,625164,6537313,5912149
Arizona,2009,M07,10.6,333040,3150320,2817280
Florida,2005,M06,3.9,339106,8741295,8402189
Maine,2004,M06,4.3,29669,694699,665030
Kentucky,2014,M05,6.7,136623,2024699,1888076
Washington,2008,M01,5.3,182284,3439540,3257256
Washington,2003,M05,7.3,227516,3099859,2872343
New Jersey,2010,M01,10.3,465710,4518682,4052972
Hawaii,2001,M02,4.0,24237,609574,585337
North Carolina,2007,M05,4.6,206181,4510789,4304608
Washington,2013,M08,6.8,234970,3467611,3232641
Idaho,2005,M03,4.9,35669,721886,686217
Pennsylvania,2013,M06,7.7,504945,6524732,6019787
Michigan,2009,M01,12.1,586351,4834402,4248051
New Mexico,2014,M12,6.0,55533,927990,872457
Indiana,2002,M07,5.2,165639,3211557,3045918
Wyoming,2006,M07,2.9,8227,286458,278231
Washington,2000,M06,5.0,153912,3078825,2924913
Georgia,2000,M04,3.3,138511,4210397,4071886
Puerto Rico,2008,M02,10.8,146669,1359444,1212775
Delaware,2005,M08,4.2,18460,438229,419769
Vermont,2016,M07,3.4,11996,351345,339349
Colorado,2012,M04,8.0,219708,2736583,2516875
Rhode Island,2013,M06,8.8,49489,559568,510079
Connecticut,2010,M02,9.5,178344,1879796,1701452
Wyoming,2002,M12,4.5,12019,269905,257886
Florida,2001,M01,3.9,313332,7956239,7642907
Kentucky,2005,M02,6.6,129779,1970046,1840267
North Carolina,2008,M04,4.9,221212,4533833,4312621
Nebraska,2002,M07,3.8,37189,969915,932726
Maine,2009,M07,7.8,55803,712431,656628
Vermont,2009,M05,6.8,24365,359065,334700
Louisiana,2015,M03,6.4,139127,2164660,2025533
South Dakota,2006,M06,3.0,13354,443272,429918
Delaware,2009,M01,7.8,34628,443646,409018
Maryland,2013,M05,6.6,207700,3128802,2921102
Connecticut,2000,M03,2.9,50257,1759588,1709331
Pennsylvania,2014,M06,6.0,385210,6453591,6068381
Vermont,2000,M11,2.8,9174,332338,323164
South Dakota,2012,M02,5.0,22027,436366,414339
Colorado,2005,M08,4.7,122086,2585531,2463445
Mississippi,2013,M11,7.6,94744,1252288,1157544
Alabama,2003,M04,5.3,112249,2107579,1995330
Montana,2006,M08,3.0,15167,503041,487874
Arkansas,2009,M10,7.6,102131,1350555,1248424
Mississippi,2001,M08,5.5,70378,1278112,1207734
Kentucky,2011,M03,10.0,205575,2061381,1855806
Washington,2016,M10,5.0,184152,3681300,3497148
North Carolina,2003,M06,7.0,303057,4307938,4004881
Nebraska,2005,M11,3.3,32066,971064,938998
Alaska,2008,M09,5.9,21227,357059,335832
Maine,2014,M01,7.0,48823,694776,645953
Wisconsin,2004,M07,4.9,151983,3082337,2930354
North Dakota,2012,M05,2.7,10719,397998,387279
Idaho,2009,M10,8.5,64720,759159,694439
Louisiana,2004,M04,5.5,111256,2021975,1910719
New York,2010,M09,8.2,789479,9575209,8785730
Massachusetts,2013,M05,6.7,234009,3497680,3263671
Idaho,2015,M02,5.0,39153,784469,745316
Iowa,2015,M12,3.8,64455,1693983,1629528
North Dakota,2001,M07,2.6,9202,349397,340195
Mississippi,2005,M09,9.8,128614,1312093,1183479
Arizona,2009,M12,10.6,327651,3098866,2771215
South Dakota,2001,M06,3.0,12827,421641,408814
Maine,2002,M01,5.0,32821,661506,628685
New Mexico,2001,M04,4.6,39600,852486,812886
North Carolina,2002,M09,5.9,246329,4185261,3938932
New Mexico,2015,M10,6.3,58646,926403,867757
Rhode Island,2000,M04,3.7,19977,538289,518312
South Dakota,2010,M01,5.9,25597,434007,408410
Wisconsin,2013,M02,7.9,243856,3069631,2825775
Minnesota,2011,M07,7.1,212461,2990658,2778197
California,2016,M06,5.6,1060958,19106981,18046023
North Carolina,2000,M06,3.7,153339,4172942,4019603
New Hampshire,2016,M01,3.3,24654,742972,718318
Utah,2003,M01,6.2,74128,1188802,1114674
Nebraska,2008,M05,3.1,30506,992277,961771
Louisiana,2010,M01,8.2,167016,2038340,1871324
Oklahoma,2016,M05,4.9,89887,1822419,1732532
Delaware,2010,M03,9.0,38614,430171,391557
Virginia,2012,M02,6.6,276817,4210399,3933582
Kansas,2016,M10,4.0,59924,1483972,1424048
Oregon,2002,M11,7.3,134000,1840972,1706972
Tennessee,2012,M07,8.5,266875,3138780,2871905
Mississippi,2013,M10,8.3,104778,1255835,1151057
Missouri,2015,M02,6.1,189039,3086656,2897617
Washington,2004,M06,6.2,199413,3209124,3009711
North Carolina,2010,M04,10.9,508509,4657670,4149161
New Jersey,2012,M09,9.0,408942,4564678,4155736
Nevada,2014,M10,7.3,101705,1401905,1300200
Montana,2006,M03,4.4,21486,487943,466457
Ohio,2010,M07,10.1,598459,5902758,5304299
Michigan,2000,M09,3.4,173867,5123524,4949657
New Mexico,2003,M06,6.7,59847,897701,837854
New Jersey,2009,M10,9.4,427145,4526984,4099839
Nevada,2003,M09,5.0,57196,1152614,1095418
Rhode Island,2014,M08,7.5,41927,560670,518743
Connecticut,2000,M08,2.3,41626,1780568,1738942
South Carolina,2013,M03,7.8,168781,2172596,2003815
Minnesota,2011,M01,7.7,225374,2919318,2693944
Arizona,2005,M12,4.2,121636,2929754,2808118
Nebraska,2013,M12,3.4,34407,1010689,976282
Colorado,2005,M09,4.6,118063,2578172,2460109
New Mexico,2004,M07,5.9,53247,909214,855967
Alabama,2013,M02,8.0,173129,2170603,1997474
District of Columbia,2011,M06,10.9,38385,353736,315351
Georgia,2015,M06,6.4,306070,4797679,4491609
Rhode Island,2005,M02,5.7,31818,557906,526088
Washington,2006,M07,5.0,167522,3351809,3184287
Colorado,2000,M03,3.0,71050,2345469,2274419
Louisiana,2014,M05,6.0,128987,2138571,2009584
Nevada,2007,M01,4.6,60006,1311399,1251393
Delaware,2005,M03,4.2,17780,424727,406947
Virginia,2010,M12,6.7,276334,4154452,3878118
Idaho,2008,M02,4.0,29895,740882,710987
Kentucky,2010,M05,10.0,206687,2061468,1854781
California,2007,M02,5.4,956853,17796066,16839213
Utah,2006,M03,3.5,45153,1297239,1252086
Nevada,2012,M04,11.4,156750,1371117,1214367
Texas,2013,M02,6.5,830739,12782790,11952051
South Carolina,2003,M08,7.1,142440,2015130,1872690
New York,2011,M03,8.2,781659,9482877,8701218
New Mexico,2003,M04,5.5,48483,881544,833061
Connecticut,2001,M05,3.1,54102,1759698,1705596
Indiana,2005,M10,5.0,161923,3233995,3072072
Illinois,2016,M10,5.6,363282,6520067,6156785
Connecticut,2008,M01,5.4,100621,1859684,1759063
New Mexico,2005,M12,4.2,38487,925852,887365
Nevada,2001,M01,5.1,56365,1095321,1038956
Hawaii,2010,M08,7.0,45427,652281,606854
New Mexico,2000,M09,4.6,39233,846283,807050
Wisconsin,2015,M02,5.5,170432,3077954,2907522
Nevada,2004,M06,4.4,52414,1177881,1125467
Kentucky,2016,M07,5.1,103089,2004794,1901705
Iowa,2008,M07,4.0,68317,1701059,1632742
Maryland,2010,M08,7.7,240152,3106162,2866010
Florida,2014,M04,6.0,576595,9538573,8961978
Kansas,2001,M01,4.5,62292,1391297,1329005
South Dakota,2004,M12,3.9,16453,425023,408570
Arkansas,2004,M01,6.6,83585,1263994,1180409
District of Columbia,2008,M06,6.5,21575,333522,311947
Rhode Island,2003,M11,4.7,26396,561157,534761
Texas,2011,M01,8.3,1019687,12357777,11338090
North Carolina,2010,M12,10.3,473066,4579735,4106669
Ohio,2005,M11,5.6,332006,5923975,5591969
Alaska,2000,M05,6.4,20446,320673,300227
Iowa,2008,M03,4.2,70777,1668726,1597949
Iowa,2004,M12,4.6,73205,1605459,1532254
Colorado,2016,M06,3.7,107876,2910847,2802971
Alabama,2002,M06,6.3,132757,2108562,1975805
Idaho,2008,M07,5.0,38962,772603,733641
Arkansas,2011,M11,7.4,100607,1361933,1261326
New Jersey,2003,M05,5.8,250230,4329735,4079505
South Dakota,2011,M08,4.4,19511,445385,425874
Idaho,2013,M04,6.6,50540,766760,716220
North Dakota,2003,M01,4.8,16029,335233,319204
Puerto Rico,2006,M03,9.3,132978,1429860,1296882
Tennessee,2016,M09,5.2,164593,3160765,2996172
Washington,2014,M12,5.9,208175,3510333,3302158
Maine,2001,M10,3.6,24700,679291,654591
New York,2009,M08,8.5,824239,9739253,8915014
Washington,2008,M05,5.0,174180,3457960,3283780
Texas,2002,M06,6.9,746614,10796850,10050236
New York,2002,M03,6.6,606896,9232504,8625608
Texas,2001,M04,4.3,453909,10490080,10036171
Oregon,2002,M07,7.2,133265,1853703,1720438
South Dakota,2003,M11,3.4,14632,424626,409994
Washington,2009,M09,9.7,346390,3555553,3209163
Georgia,2016,M07,5.7,283213,4948936,4665723
Nevada,2007,M06,4.5,59842,1331343,1271501
South Carolina,2016,M05,4.5,103766,2301982,2198216
New Hampshire,2008,M06,3.6,27346,749700,722354
Utah,2010,M07,8.0,109981,1367062,1257081
Minnesota,2013,M09,4.4,129223,2953909,2824686
Nebraska,2014,M11,2.6,25752,1005222,979470
Vermont,2005,M04,3.8,12988,344792,331804
Rhode Island,2003,M02,6.1,33955,556805,522850
Wisconsin,2009,M07,8.8,277205,3152753,2875548
Illinois,2002,M05,6.3,397605,6349997,5952392
Hawaii,2014,M01,4.7,31399,661220,629821
Iowa,2008,M12,5.4,90021,1682045,1592024
Pennsylvania,2008,M09,5.0,325151,6465383,6140232
Alabama,2004,M01,6.4,134673,2120559,1985886
Rhode Island,2002,M07,5.2,29213,556615,527402
California,2005,M02,6.1,1067481,17445861,16378380
South Carolina,2012,M05,9.2,201232,2198572,1997340
Kentucky,2014,M11,5.1,100257,1982908,1882651
Alaska,2002,M04,7.6,24382,320781,296399
Virginia,2009,M04,6.2,256044,4135498,3879454
Kentucky,2003,M08,5.8,114247,1956410,1842163
Iowa,2011,M01,6.7,111695,1667406,1555711
Texas,2001,M06,5.3,559974,10561785,10001811
Arkansas,2000,M05,4.2,53083,1266504,1213421
Tennessee,2006,M03,5.5,162793,2977145,2814352
Illinois,2001,M03,5.4,353373,6498461,6145088
Alaska,2003,M06,7.9,26743,338683,311940
Tennessee,2006,M02,5.6,165232,2956977,2791745
Louisiana,2002,M11,6.0,120529,2006316,1885787
Hawaii,2008,M01,3.2,20428,638789,618361
Pennsylvania,2000,M11,4.0,245774,6118632,5872858
Alabama,2002,M01,6.5,134750,2088564,1953814
Arkansas,2003,M07,6.5,83278,1286003,1202725
Nebraska,2004,M05,3.7,35688,972206,936518
Puerto Rico,2000,M12,8.9,114426,1280556,1166130
Idaho,2013,M12,5.3,41153,769847,728694
Georgia,2000,M06,4.0,168502,4235867,4067365
Arkansas,2001,M08,4.8,60716,1255988,1195272
West Virginia,2010,M12,8.6,69522,804033,734511
Rhode Island,2014,M09,6.8,37853,555050,517197
Oregon,2015,M05,5.5,108460,1961642,1853182
New York,2007,M01,5.0,473001,9486409,9013408
Mississippi,2003,M05,6.6,85289,1297912,1212623
Utah,2015,M04,3.5,50006,1448888,1398882
Delaware,2006,M07,3.6,16201,446110,429909
Oregon,2005,M11,5.7,105125,1858326,1753201
Puerto Rico,2016,M07,12.5,140449,1125198,984749
Delaware,2004,M02,4.4,18149,416778,398629
Alaska,2005,M02,8.2,27829,339033,311204
Idaho,2002,M06,5.0,34830,693328,658498
Indiana,2001,M11,5.0,156134,3147110,2990976
New York,2014,M10,5.6,540873,9586914,9046041
Georgia,2014,M07,8.0,385526,4803543,4418017
Colorado,2014,M06,5.1,143853,2831077,2687224
Florida,2014,M06,6.4,616487,9611402,8994915
Iowa,2006,M06,3.6,60177,1674258,1614081
Maryland,2015,M01,5.9,182978,3121138,2938160
Kansas,2006,M09,4.2,61054,1464430,1403376
Georgia,2012,M06,9.7,466230,4810916,4344686
North Carolina,2008,M05,5.5,253099,4564270,4311171
Wyoming,2010,M06,6.2,19067,307449,288382
Texas,2003,M04,6.5,709538,10900895,10191357
Indiana,2003,M05,5.1,161746,3189567,3027821
Minnesota,2016,M05,3.3,98186,2995353,2897167
Arizona,2005,M03,4.7,133637,2836300,2702663
Connecticut,2006,M11,4.0,74356,1843394,1769038
North Dakota,2007,M02,3.9,14066,362335,348269
Maryland,2005,M01,4.6,133015,2881748,2748733
Alaska,2005,M08,5.7,20035,351123,331088
Arkansas,2011,M03,8.6,116338,1357428,1241090
Missouri,2015,M12,4.0,122050,3076700,2954650
Rhode Island,2009,M11,10.6,60335,568013,507678
Florida,2011,M11,9.1,846475,9315528,8469053
New Jersey,2011,M04,9.1,413747,4545120,4131373
Idaho,2001,M03,5.8,38738,670240,631502
Minnesota,2004,M06,4.9,142904,2908153,2765249
West Virginia,2004,M04,5.6,43930,784062,740132
Iowa,2015,M08,3.7,62367,1700003,1637636
Oklahoma,2002,M04,4.4,73433,1685911,1612478
Idaho,2001,M12,5.6,37926,678959,641033
Maine,2016,M05,3.8,25865,685895,660030
District of Columbia,2013,M04,8.0,29999,373084,343085
Vermont,2008,M07,4.4,15770,359243,343473
Wisconsin,2002,M03,6.4,194056,3008878,2814822
Florida,2013,M06,7.7,729810,9516278,8786468
Massachusetts,2007,M05,4.4,149922,3400187,3250265
Alabama,2009,M01,9.7,208908,2164104,1955196
District of Columbia,2008,M12,7.7,25403,330248,304845
Maryland,2001,M11,4.5,127178,2855478,2728300
Maryland,2002,M05,4.3,123413,2863363,2739950
District of Columbia,2001,M08,6.6,20790,314744,293954
Pennsylvania,2005,M06,5.1,323416,6304012,5980596
Missouri,2011,M05,8.4,256809,3058241,2801432
Georgia,2005,M02,5.6,254371,4519690,4265319
Georgia,2014,M12,6.1,291096,4756684,4465588
Tennessee,2004,M11,5.5,159972,2885685,2725713
Washington,2008,M06,5.2,181375,3488407,3307032
Rhode Island,2008,M11,8.7,49631,571686,522055
Louisiana,2003,M03,6.3,125545,2006286,1880741
South Dakota,2002,M06,2.9,12546,425774,413228
Wyoming,2009,M06,6.7,20524,305996,285472
Alaska,2004,M05,7.4,24705,335229,310524
Ohio,2016,M07,5.0,289528,5778517,5488989
Connecticut,2004,M03,5.4,94842,1762129,1667287
Massachusetts,2012,M07,6.9,244361,3532478,3288117
Puerto Rico,2000,M07,10.0,129775,1299787,1170012
Idaho,2005,M07,3.6,26801,744925,718124
North Dakota,2011,M05,3.1,12157,388638,376481
Idaho,2008,M03,3.9,29253,741596,712343
Arizona,2008,M05,5.4,165262,3080441,2915179
Maine,2004,M08,3.9,27580,703884,676304
North Carolina,2002,M01,7.4,305801,4151099,3845298
Kentucky,2015,M03,5.6,110547,1964808,1854261
Colorado,2013,M11,6.0,166869,2770908,2604039
New Jersey,2007,M05,4.1,178929,4413466,4234537
District of Columbia,2013,M02,9.0,33690,375697,342007
Utah,2014,M02,4.5,63807,1419545,1355738
South Carolina,2002,M08,5.9,115827,1970109,1854282
Hawaii,2015,M05,3.6,24150,672964,648814
Washington,2012,M05,8.2,285613,3477294,3191681
Tennessee,2007,M05,4.0,122180,3052811,2930631
Louisiana,2004,M08,5.9,121753,2046820,1925067
Pennsylvania,2006,M06,4.9,308225,6354017,6045792
Alabama,2011,M09,9.5,208118,2201614,1993496
Illinois,2002,M10,6.1,382728,6313801,5931073
Tennessee,2014,M01,6.7,201102,2999401,2798299
Michigan,2011,M11,8.5,398000,4661302,4263302
Arkansas,2001,M04,4.6,57904,1252572,1194668
Arizona,2003,M08,6.2,171352,2744690,2573338
Missouri,2008,M11,6.7,202975,3033521,2830546
Arizona,2008,M04,4.7,144983,3072584,2927601
Texas,2008,M11,5.2,617765,11779786,11162021
Louisiana,2001,M06,6.3,130304,2063558,1933254
North Carolina,2011,M06,10.8,501822,4651492,4149670
Montana,2008,M07,4.6,23922,520165,496243
Texas,2004,M11,5.7,632532,11073171,10440639
Vermont,2013,M11,4.0,13893,349995,336102
South Dakota,2013,M06,3.6,16312,452524,436212
Michigan,2005,M10,5.8,295505,5087939,4792434
Alabama,2003,M12,5.7,121278,2133537,2012259
Illinois,2009,M09,10.4,687073,6579986,5892913
Wyoming,2013,M12,4.6,14116,305285,291169
Delaware,2009,M05,8.0,35059,439506,404447
Indiana,2016,M11,3.9,127730,3316013,3188283
Minnesota,2003,M11,4.5,129163,2877113,2747950
Maine,2003,M09,4.5,30753,686108,655355
Nevada,2015,M12,6.2,87584,1416133,1328549
South Dakota,2015,M07,2.8,12917,459362,446445
Mississippi,2002,M07,6.8,87516,1294242,1206726
Arizona,2012,M01,8.8,266493,3012695,2746202
Nevada,2016,M12,4.9,70178,1429013,1358835
New York,2007,M04,4.2,394382,9418770,9024388
West Virginia,2007,M03,5.0,40022,802149,762127
Oklahoma,2001,M03,3.4,57287,1671325,1614038
California,2005,M11,5.3,934144,17615494,16681350
New Hampshire,2003,M10,3.9,27386,708482,681096
Nevada,2015,M05,6.7,94176,1415240,1321064
Puerto Rico,2008,M12,13.3,179608,1345972,1166364
Colorado,2005,M01,5.7,143549,2528481,2384932
New York,2005,M05,4.8,447903,9411425,8963522
West Virginia,2002,M09,5.3,42161,801460,759299
Oklahoma,2004,M09,4.5,75283,1685328,1610045
Kentucky,2001,M09,4.9,96182,1946008,1849826
Utah,2012,M08,5.4,73865,1379250,1305385
North Dakota,2004,M04,3.4,11958,349283,337325
Idaho,2002,M12,5.7,39164,685142,645978
Puerto Rico,2007,M05,10.8,151419,1396669,1245250
Massachusetts,2015,M12,4.2,150878,3576971,3426093
North Carolina,2008,M06,5.9,271173,4584954,4313781
Utah,2001,M06,4.7,55027,1171045,1116018
Kentucky,2016,M05,4.8,96565,1991254,1894689
Missouri,2001,M12,4.9,146942,2979980,2833038
Nevada,2010,M02,13.5,183187,1353773,1170586
North Carolina,2005,M12,4.5,193679,4322127,4128448
Oregon,2005,M03,6.9,125849,1827376,1701527
Alabama,2004,M04,5.2,111309,2120865,2009556
Utah,2012,M02,6.3,85873,1356216,1270343
Delaware,2014,M10,5.2,23998,457266,433268
South Carolina,2000,M01,4.3,84332,1972237,1887905
South Carolina,2007,M07,5.8,125358,2157247,2031889
District of Columbia,2015,M06,7.1,27440,388390,360950
Maine,2009,M03,9.1,62551,689926,627375
New Jersey,2003,M07,6.4,281773,4408393,4126620
Ohio,2012,M03,7.8,443571,5685901,5242330
Colorado,2012,M03,8.5,234466,2742711,2508245
Florida,2003,M07,5.7,468390,8243206,7774816
Idaho,2009,M09,8.6,65144,757168,692024
Indiana,2012,M04,7.7,242795,3147521,2904726
Puerto Rico,2000,M11,8.9,114038,1274382,1160344
Rhode Island,2012,M10,9.5,53139,559630,506491
North Dakota,2013,M10,2.0,8315,407873,399558
Kansas,2006,M11,4.0,59808,1477249,1417441
California,2006,M11,4.8,850156,17795689,16945533
North Carolina,2004,M05,5.5,231742,4248524,4016782
Kansas,2005,M11,4.7,69085,1469384,1400299
Indiana,2007,M05,4.2,135658,3199265,3063607
Vermont,2016,M06,3.4,12015,349875,337860
Connecticut,2000,M02,3.2,56950,1755809,1698859
District of Columbia,2003,M06,7.4,23069,312167,289098
South Carolina,2016,M07,5.0,115692,2327413,2211721
Maryland,2007,M07,3.7,112256,3025562,2913306
Puerto Rico,2004,M10,10.1,136674,1348220,1211546
New Hampshire,2011,M03,5.7,41929,734451,692522
Missouri,2004,M07,6.4,194516,3056398,2861882
Michigan,2001,M12,6.0,304654,5061112,4756458
New Hampshire,2014,M09,3.8,28179,736914,708735
Louisiana,2002,M08,6.4,128408,2013706,1885298
New Mexico,2003,M08,6.0,53271,892110,838839
Michigan,2002,M10,5.2,261859,4998177,4736318
Connecticut,2011,M01,9.8,186198,1906336,1720138
Wyoming,2015,M08,3.9,11872,307846,295974
Massachusetts,2009,M10,8.2,285378,3459922,3174544
Massachusetts,2000,M09,2.5,83192,3296912,3213720
Maine,2002,M03,4.9,32608,662977,630369
Colorado,2007,M03,3.8,101056,2630010,2528954
Idaho,2013,M11,5.6,43465,773447,729982
Virginia,2001,M06,3.2,119989,3696124,3576135
Nebraska,2011,M06,4.7,47377,1014404,967027
New York,2004,M12,5.2,491247,9397416,8906169
Illinois,2014,M04,6.8,441328,6460670,6019342
Connecticut,2008,M04,4.8,88567,1859175,1770608
Oregon,2012,M06,8.9,174432,1969147,1794715
District of Columbia,2000,M06,5.6,17577,312431,294854
Washington,2015,M10,5.3,188424,3562865,3374441
New Hampshire,2002,M12,4.2,29681,701240,671559
Arizona,2013,M11,7.2,219701,3054748,2835047
New York,2001,M04,4.1,372755,9074146,8701391
Nevada,2012,M02,11.9,163557,1373443,1209886
Arizona,2014,M11,6.3,196962,3140134,2943172
District of Columbia,2006,M09,6.0,18835,316012,297177
North Dakota,2002,M09,3.0,10120,340608,330488
New York,2014,M03,7.1,677725,9596799,8919074
Minnesota,2009,M02,8.3,242595,2931747,2689152
North Dakota,2015,M05,2.6,10665,416200,405535
Alabama,2006,M04,3.5,76310,2150482,2074172
Kansas,2001,M06,4.3,60257,1404958,1344701
California,2010,M10,11.9,2188602,18348942,16160340
Texas,2012,M07,7.3,931555,12727882,11796327
Utah,2005,M06,4.4,56410,1277088,1220678
Virginia,2016,M07,4.2,180463,4283528,4103065
New Jersey,2001,M03,4.0,169433,4261799,4092366
South Dakota,2003,M09,3.2,13640,421358,407718
Maine,2003,M10,4.5,30993,689566,658573
Massachusetts,2010,M06,8.4,297261,3525224,3227963
Pennsylvania,2015,M01,6.0,385013,6396592,6011579
Florida,2000,M12,3.3,264489,7957508,7693019
California,2001,M09,5.5,934020,17132118,16198098
New Hampshire,2001,M04,3.0,20627,690558,669931
Wisconsin,2014,M12,4.6,140130,3073486,2933356
Nebraska,2004,M06,4.0,39693,982550,942857
Nevada,2015,M06,7.0,99356,1418335,1318979
Indiana,2003,M07,5.8,186196,3223440,3037244
Minnesota,2016,M07,3.8,115174,3032161,2916987
Oregon,2015,M06,5.8,115237,1985465,1870228
Arkansas,2016,M01,4.7,61989,1321884,1259895
South Carolina,2011,M12,9.9,213746,2158650,1944904
Alabama,2013,M07,7.6,165324,2180234,2014910
Nevada,2002,M08,5.3,60092,1133071,1072979
Utah,2009,M10,7.3,99374,1359037,1259663
Tennessee,2002,M03,6.0,172752,2901368,2728616
Missouri,2004,M12,5.7,171491,3000664,2829173
Idaho,2011,M10,7.2,55325,767220,711895
Utah,2016,M01,3.9,58060,1483167,1425107
Nevada,2004,M07,4.4,51663,1184637,1132974
Texas,2007,M10,4.0,462928,11474584,11011656
Idaho,2010,M12,9.0,67850,757375,689525
Hawaii,2012,M01,6.8,44190,651076,606886
Delaware,2000,M09,3.6,15021,412040,397019
West Virginia,2007,M11,4.0,32785,813431,780646
Oklahoma,2001,M11,4.3,72193,1693027,1620834
New York,2006,M04,4.6,435725,9457560,9021835
Colorado,2006,M06,4.6,121906,2641856,2519950
Puerto Rico,2003,M12,10.1,135041,1342181,1207140
Missouri,2000,M09,3.6,106154,2944489,2838335
Massachusetts,2007,M07,4.7,165169,3478376,3313207
Washington,2007,M03,5.0,168358,3374113,3205755
Utah,2011,M09,6.1,82635,1350945,1268310
Mississippi,2016,M03,5.6,71300,1273091,1201791
Massachusetts,2016,M02,4.6,165935,3578493,3412558
Maryland,2005,M09,3.9,113755,2932275,2818520
New Mexico,2014,M10,6.2,57970,928351,870381
Nebraska,2010,M04,4.6,45261,992636,947375
Illinois,2008,M04,5.2,345407,6650421,6305014
Texas,2004,M08,5.8,638902,10984277,10345375
Washington,2003,M01,8.1,251969,3094462,2842493
Pennsylvania,2011,M12,7.4,471664,6401662,5929998
Montana,2009,M08,6.2,31313,507344,476031
Florida,2015,M09,5.4,515981,9630265,9114284
West Virginia,2006,M01,5.2,40661,789170,748509
Georgia,2008,M06,6.1,302548,4948991,4646443
Wisconsin,2005,M07,4.6,142261,3065400,2923139
Oklahoma,2000,M01,3.5,57436,1647052,1589616
Tennessee,2001,M07,4.4,126778,2881810,2755032
Florida,2010,M01,11.5,1041406,9020311,7978905
Missouri,2008,M12,7.4,222544,3026512,2803968
Maryland,2016,M05,4.0,125543,3151996,3026453
Nevada,2004,M02,4.7,54972,1163497,1108525
Wisconsin,2006,M04,4.9,147720,3029417,2881697
North Dakota,2003,M03,4.7,16005,338534,322529
Utah,2007,M02,2.7,36307,1338974,1302667
Utah,2015,M12,3.4,49669,1481231,1431562
Arkansas,2007,M03,5.2,71726,1368306,1296580
Kansas,2002,M08,5.2,73353,1414724,1341371
California,2005,M08,5.1,901053,17623138,16722085
Arkansas,2002,M09,4.9,62685,1278283,1215598
New Hampshire,2003,M04,4.3,30327,697860,667533
Alabama,2008,M10,6.3,137392,2185049,2047657
California,2012,M04,10.3,1894553,18388262,16493709
Washington,2011,M07,9.1,316851,3480001,3163150
Maine,2000,M06,3.1,21369,689517,668148
Tennessee,2016,M04,4.2,130382,3106445,2976063
Tennessee,2004,M08,5.4,154195,2881988,2727793
Maryland,2015,M10,4.8,151939,3156821,3004882
Iowa,2004,M09,4.3,67983,1598101,1530118
Washington,2009,M08,9.6,342877,3565648,3222771
Iowa,2016,M06,3.8,65910,1716732,1650822
West Virginia,2012,M10,7.0,56558,813548,756990
Oklahoma,2010,M10,6.5,114972,1772959,1657987
California,2009,M12,11.8,2134358,18074801,15940443
Pennsylvania,2009,M06,8.4,543979,6476767,5932788
New York,2003,M07,6.4,598353,9349037,8750684
Arizona,2000,M11,3.5,88392,2527802,2439410
New York,2000,M08,4.5,410289,9181351,8771062
Wyoming,2010,M12,6.2,18913,304124,285211
District of Columbia,2002,M11,6.3,19172,302380,283208
Vermont,2012,M10,4.1,14489,353265,338776
Alabama,2005,M06,5.0,107168,2155898,2048730
Colorado,2009,M06,7.7,211371,2756326,2544955
Ohio,2009,M05,10.2,605407,5928248,5322841
New Jersey,2000,M05,3.5,149107,4266969,4117862
Montana,2005,M02,5.4,25624,478157,452533
Tennessee,2003,M09,5.5,158855,2886648,2727793
Colorado,2012,M01,8.6,233462,2729616,2496154
New Hampshire,2008,M07,3.6,27263,756568,729305
Wisconsin,2016,M05,3.8,119416,3106700,2987284
Arkansas,2014,M03,6.5,83987,1292789,1208802
Tennessee,2016,M05,4.2,130525,3119543,2989018
Puerto Rico,2012,M09,14.3,168175,1177843,1009668
West Virginia,2011,M05,7.8,62981,806568,743587
Indiana,2012,M05,8.0,253390,3177005,2923615
Oklahoma,2013,M05,5.3,96401,1810898,1714497
Minnesota,2013,M12,4.5,132808,2945647,2812839
South Carolina,2012,M12,8.6,186783,2175560,1988777
Indiana,2013,M09,6.8,218292,3193875,2975583
Delaware,2008,M12,6.3,28269,445831,417562
Louisiana,2009,M12,7.0,143321,2040949,1897628
Colorado,2000,M01,3.2,75513,2341467,2265954
Minnesota,2004,M08,4.4,128015,2900944,2772929
Missouri,2008,M04,4.7,140886,3010738,2869852
Wyoming,2001,M06,3.8,10364,275476,265112
California,2013,M07,9.3,1751371,18751280,16999909
Pennsylvania,2010,M06,8.6,551616,6435883,5884267
Nevada,2005,M02,4.3,52129,1201673,1149544
Iowa,2012,M11,4.5,73601,1652867,1579266
Colorado,2001,M08,4.0,95461,2402546,2307085
Washington,2014,M04,5.7,197205,3452508,3255303
Vermont,2003,M10,3.4,11930,346803,334873
Arizona,2012,M04,8.0,242088,3017136,2775048
Tennessee,2013,M01,8.7,268624,3084527,2815903
Pennsylvania,2012,M07,8.6,565474,6571772,6006298
New Hampshire,2015,M01,4.3,32147,739823,707676
Virginia,2004,M08,3.8,144376,3811302,3666926
Louisiana,2000,M04,4.4,88864,2036144,1947280
Iowa,2016,M11,3.0,50922,1691617,1640695
North Carolina,2015,M01,6.1,285454,4699440,4413986
Kansas,2011,M03,6.9,103354,1488676,1385322
West Virginia,2014,M02,8.1,64386,792263,727877
Oklahoma,2008,M02,3.5,60405,1711628,1651223
Maine,2000,M11,3.2,21744,671813,650069
Hawaii,2009,M08,7.3,45815,631749,585934
South Carolina,2000,M12,3.7,72211,1967286,1895075
Tennessee,2014,M04,5.9,177646,3015143,2837497
Maryland,2010,M10,7.3,224454,3086187,2861733
South Dakota,2005,M06,3.8,16766,438953,422187
South Carolina,2016,M03,5.1,117246,2289595,2172349
Illinois,2009,M11,10.4,681984,6579391,5897407
New Hampshire,2016,M07,2.8,21521,761939,740418
Nebraska,2001,M11,3.0,28432,950948,922516
Missouri,2003,M10,5.1,154858,3017218,2862360
Indiana,2007,M04,4.4,140909,3193362,3052453
Pennsylvania,2016,M06,5.7,370348,6521308,6150960
Arizona,2004,M08,5.3,148564,2809167,2660603
Texas,2008,M09,5.1,593741,11740046,11146305
Georgia,2010,M09,10.5,493268,4699655,4206387
Alabama,2004,M11,5.2,111612,2154764,2043152
Alabama,2011,M11,8.0,175369,2183973,2008604
Hawaii,2013,M09,5.0,32288,649418,617130
Arizona,2013,M12,7.0,213499,3050002,2836503
Wisconsin,2011,M11,6.7,205183,3069857,2864674
North Carolina,2016,M10,5.1,251212,4928025,4676813
Wyoming,2001,M01,4.8,12691,265854,253163
Louisiana,2006,M06,5.1,103508,2020128,1916620
Kansas,2000,M03,3.7,52561,1411912,1359351
Ohio,2008,M03,6.0,356557,5920533,5563976
Louisiana,2003,M01,6.9,137064,1991076,1854012
Alaska,2016,M04,6.8,24232,356340,332108
Nebraska,2001,M02,3.3,31003,942580,911577
Texas,2006,M04,4.9,547441,11269852,10722411
Maryland,2012,M04,6.5,201822,3087456,2885634
Wyoming,2013,M01,6.1,18473,303988,285515
Kentucky,2011,M04,9.1,187776,2056134,1868358
District of Columbia,2007,M06,5.8,18847,323949,305102
Kansas,2005,M02,5.6,81494,1462405,1380911
Louisiana,2015,M01,7.3,158665,2161884,2003219
Rhode Island,2001,M01,5.2,27989,542743,514754
North Dakota,2015,M10,2.0,8413,412390,403977
New York,2006,M05,4.5,421611,9470230,9048619
New Mexico,2013,M12,6.6,61285,925826,864541
Georgia,2009,M11,10.2,491461,4796485,4305024
Ohio,2005,M08,5.4,321451,5948043,5626592
Oregon,2000,M12,4.7,85094,1808680,1723586
Michigan,2016,M03,5.3,256851,4825198,4568347
West Virginia,2000,M02,6.9,55693,805841,750148
Oklahoma,2006,M02,4.3,72331,1695549,1623218
Colorado,2009,M12,8.0,216554,2693828,2477274
Kentucky,2009,M08,10.4,214285,2062225,1847940
Illinois,2008,M05,6.0,397462,6676767,6279305
Maine,2014,M03,6.7,46491,693775,647284
North Carolina,2002,M12,6.5,269770,4143907,3874137
Connecticut,2003,M10,5.0,89132,1782187,1693055
District of Columbia,2002,M02,6.8,20843,307434,286591
Indiana,2002,M01,6.1,190239,3130949,2940710
California,2003,M06,7.2,1242949,17343499,16100550
Hawaii,2005,M10,2.8,17504,629197,611693
New Mexico,2005,M11,4.5,41356,927790,886434
Louisiana,2014,M07,7.2,158408,2196778,2038370
Louisiana,2000,M10,5.3,108765,2037042,1928277
Michigan,2000,M10,3.1,157381,5137955,4980574
Iowa,2009,M11,5.9,98329,1677758,1579429
Oregon,2008,M06,5.9,114763,1959561,1844798
District of Columbia,2004,M06,8.3,25978,314163,288185
Kentucky,2011,M01,10.7,218733,2046114,1827381
West Virginia,2007,M01,5.1,40520,797648,757128
Oklahoma,2001,M01,3.2,52704,1652228,1599524
Ohio,2008,M01,6.2,367749,5920318,5552569
Nebraska,2001,M07,3.3,32323,967641,935318
Wisconsin,2011,M09,7.0,215048,3079559,2864511
Texas,2009,M03,6.5,763112,11731611,10968499
South Dakota,2011,M11,4.2,18410,440525,422115
West Virginia,2015,M05,6.9,54401,788860,734459
Indiana,2000,M05,3.2,101122,3141024,3039902
Oklahoma,2009,M05,6.5,115558,1769352,1653794
Nevada,2011,M11,12.3,169504,1375890,1206386
Hawaii,2012,M03,6.5,42426,650303,607877
Wisconsin,2004,M04,5.3,158991,3017833,2858842
Oregon,2004,M06,7.4,136569,1851648,1715079
Arkansas,2003,M01,6.4,79753,1252788,1173035
Nebraska,2006,M11,2.7,26285,971583,945298
Arizona,2006,M08,4.6,137621,3010264,2872643
Alaska,2011,M09,6.7,24616,367706,343090
West Virginia,2001,M01,6.1,48704,804833,756129
Oklahoma,2007,M01,4.6,77963,1708732,1630769
Iowa,2009,M08,6.4,107436,1686267,1578831
Ohio,2001,M06,4.3,250537,5852916,5602379
Maryland,2014,M04,5.4,168365,3093088,2924723
Kansas,2009,M06,7.2,111426,1541355,1429929
Virginia,2001,M12,3.9,143140,3665822,3522682
Iowa,2001,M02,3.7,59947,1599709,1539762
Arizona,2015,M04,5.8,181351,3148501,2967150
Louisiana,2002,M09,6.0,119333,2004582,1885249
Hawaii,2014,M04,4.4,29072,664657,635585
South Dakota,2004,M07,3.6,15543,437530,421987
Mississippi,2006,M09,6.1,78412,1286713,1208301
Kentucky,2013,M04,7.7,158575,2064118,1905543
Kansas,2003,M02,5.4,76301,1422832,1346531
Maryland,2016,M07,4.4,142953,3219317,3076364
Idaho,2008,M05,4.7,35411,759271,723860
Kentucky,2006,M11,5.2,105390,2044654,1939264
Arizona,2008,M03,4.7,145028,3065528,2920500
Nebraska,2014,M10,2.7,27403,1007620,980217
Connecticut,2005,M09,4.7,84156,1797048,1712892
Massachusetts,2002,M06,5.5,192471,3476967,3284496
North Carolina,2005,M09,4.9,214476,4336689,4122213
Iowa,2016,M09,3.4,57646,1698623,1640977
Texas,2005,M01,5.9,652742,10994664,10341922
Kentucky,2014,M09,5.4,107711,1984376,1876665
District of Columbia,2005,M12,5.5,17292,312239,294947
North Carolina,2009,M11,10.6,482345,4552550,4070205
Massachusetts,2012,M02,7.2,247850,3451042,3203192
Nebraska,2012,M06,4.2,42933,1026656,983723
Louisiana,2010,M11,8.1,169430,2089588,1920158
South Dakota,2008,M11,3.4,15369,447165,431796
Arkansas,2013,M07,7.8,103161,1327994,1224833
New Mexico,2012,M05,6.7,61825,918914,857089
Oregon,2007,M06,5.0,96736,1929778,1833042
Alaska,2006,M04,7.0,24136,344649,320513
Virginia,2005,M04,3.5,135221,3880732,3745511
Nebraska,2010,M11,4.1,40759,993757,952998
Oregon,2001,M09,6.3,114495,1828537,1714042
Arkansas,2009,M08,7.7,104249,1359383,1255134
Florida,2011,M02,10.4,958435,9209965,8251530
Hawaii,2000,M10,4.0,23957,601720,577763
Kansas,2006,M06,4.5,66913,1484316,1417403
Nebraska,2014,M09,2.9,28859,1001048,972189
New Jersey,2015,M09,5.2,233932,4479265,4245333
Texas,2005,M10,5.0,564306,11247767,10683461
Ohio,2007,M08,5.4,325694,6025798,5700104
Missouri,2016,M08,5.2,160287,3107753,2947466
Massachusetts,2016,M11,2.8,98720,3583688,3484968
Nevada,2000,M09,4.3,46215,1080514,1034299
Delaware,2008,M08,5.2,23604,449659,426055
Ohio,2009,M07,10.7,643224,5990397,5347173
Maryland,2001,M02,3.9,108231,2807300,2699069
Kentucky,2009,M11,9.8,201275,2053479,1852204
West Virginia,2009,M11,7.6,61387,808199,746812
Oklahoma,2015,M11,4.3,80218,1847450,1767232
Arkansas,2007,M01,5.9,79419,1346290,1266871
West Virginia,2010,M11,8.3,67355,808559,741204
Oklahoma,2012,M11,5.0,91778,1822822,1731044
North Carolina,2001,M11,6.5,273947,4191949,3918002
Florida,2014,M01,6.7,630200,9448981,8818781
Colorado,2002,M09,5.3,129751,2469958,2340207
Missouri,2008,M01,5.8,175150,3006586,2831436
Mississippi,2016,M07,6.4,82624,1292473,1209849
Wisconsin,2010,M04,9.0,276028,3078882,2802854
Colorado,2010,M06,8.9,244606,2743766,2499160
Louisiana,2013,M11,5.4,114295,2108922,1994627
Pennsylvania,2007,M11,4.1,263742,6384986,6121244
Hawaii,2014,M12,3.7,24949,669508,644559
Iowa,2008,M01,4.5,75020,1660673,1585653
District of Columbia,2016,M10,5.9,23389,394704,371315
Kansas,2000,M10,3.6,50477,1397771,1347294
Kentucky,2016,M04,4.6,91540,1979563,1888023
Idaho,2009,M12,9.6,72689,756874,684185
North Carolina,2014,M07,6.9,326056,4727881,4401825
Michigan,2014,M10,6.3,299042,4767614,4468572
Delaware,2000,M06,4.0,16811,417473,400662
Mississippi,2003,M07,6.8,89769,1314954,1225185
South Carolina,2008,M09,7.5,160318,2151189,1990871
Colorado,2001,M12,5.1,122739,2420434,2297695
Virginia,2011,M12,6.2,263058,4210114,3947056
Nevada,2012,M07,11.4,157182,1384033,1226851
Virginia,2006,M04,2.9,115033,3952530,3837497
Maryland,2009,M11,7.2,219423,3035172,2815749
District of Columbia,2000,M07,5.8,18356,317911,299555
New York,2002,M01,6.8,626829,9161536,8534707
Rhode Island,2009,M12,10.7,60631,566092,505461
Missouri,2007,M08,5.4,163269,3021418,2858149
Michigan,2003,M08,7.1,360185,5046721,4686536
Missouri,2014,M02,7.6,231822,3039675,2807853
Idaho,2010,M01,10.5,79423,754144,674721
South Dakota,2007,M12,2.7,11803,439925,428122
Maryland,2002,M12,4.2,119065,2861672,2742607
Delaware,2013,M02,7.7,33810,440223,406413
Vermont,2001,M01,3.7,12187,333169,320982
Pennsylvania,2001,M06,4.9,306634,6233392,5926758
Montana,2011,M12,6.5,32577,497841,465264
Washington,2002,M08,7.1,218861,3099752,2880891
Hawaii,2002,M12,3.2,19351,597971,578620
Florida,2015,M11,5.0,486139,9626792,9140653
Florida,2012,M11,7.8,730915,9401862,8670947
Colorado,2005,M11,4.7,122187,2581541,2459354
Delaware,2003,M06,4.6,19106,418677,399571
Massachusetts,2008,M08,5.6,195388,3502576,3307188
Arkansas,2006,M12,5.0,68176,1360582,1292406
Indiana,2003,M06,5.7,183600,3230967,3047367
Minnesota,2016,M06,4.0,119516,3020836,2901320
Minnesota,2006,M10,3.4,99340,2892919,2793579
Maryland,2007,M02,3.8,112930,2940735,2827805
Louisiana,2012,M08,7.3,152848,2086726,1933878
Maryland,2005,M11,3.8,112011,2937308,2825297
Washington,2010,M09,9.3,325488,3501703,3176215
North Carolina,2014,M02,7.0,324274,4649029,4324755
Michigan,2003,M11,6.3,317392,5031245,4713853
Maine,2000,M08,2.6,18109,693461,675352
Hawaii,2009,M11,7.2,45503,629732,584229
Vermont,2006,M01,4.3,15274,354807,339533
Tennessee,2004,M06,5.4,157361,2906103,2748742
Colorado,2013,M10,6.1,169181,2774340,2605159
North Carolina,2015,M11,5.4,259919,4787092,4527173
Massachusetts,2004,M12,4.5,153196,3374592,3221396
Rhode Island,2000,M01,5.2,27991,541158,513167
South Dakota,2010,M04,4.9,21437,439611,418174
Utah,2002,M01,5.7,66328,1173034,1106706
Virginia,2016,M11,3.8,159490,4249068,4089578
Virginia,2001,M09,3.6,130766,3660866,3530100
Maryland,2006,M07,4.3,130942,3025251,2894309
Indiana,2014,M10,5.4,176554,3254995,3078441
New Hampshire,2002,M01,4.9,33811,696484,662673
Pennsylvania,2002,M06,5.8,364230,6287566,5923336
Arkansas,2005,M04,5.0,66881,1337727,1270846
Nevada,2007,M12,4.9,65731,1345718,1279987
Florida,2004,M11,4.4,379605,8559151,8179546
Pennsylvania,2007,M09,4.1,261481,6355278,6093797
North Carolina,2011,M01,10.9,500556,4578718,4078162
South Dakota,2011,M10,3.9,17245,441197,423952
Kansas,2015,M03,4.5,66358,1484634,1418276
Georgia,2000,M10,3.3,137555,4218680,4081125
Louisiana,2005,M06,6.6,139547,2108611,1969064
Colorado,2002,M11,5.6,136101,2446469,2310368
New York,2015,M09,4.8,451687,9501940,9050253
Rhode Island,2006,M01,6.1,34736,567844,533108
Idaho,2002,M10,4.6,31567,686943,655376
Rhode Island,2005,M07,5.4,30779,574836,544057
Washington,2006,M02,5.8,190156,3294741,3104585
North Carolina,2014,M11,5.7,268103,4711616,4443513
Arizona,2008,M10,7.2,227681,3146845,2919164
New Mexico,2005,M10,4.6,42278,925558,883280
Montana,2001,M09,3.7,17214,462957,445743
Hawaii,2009,M02,6.7,42283,630715,588432
Montana,2004,M05,4.3,20770,481075,460305
Michigan,2012,M11,7.9,368544,4655984,4287440
Iowa,2007,M07,3.3,55952,1677132,1621180
Colorado,2009,M02,6.9,187630,2717457,2529827
Virginia,2016,M02,4.1,174579,4211047,4036468
Alaska,2007,M04,6.5,22544,345090,322546
Delaware,2015,M02,5.3,24397,458884,434487
Utah,2013,M02,5.4,74536,1390904,1316368
North Carolina,2010,M10,9.9,456081,4607001,4150920
Utah,2008,M08,3.8,51794,1380541,1328747
Nevada,2014,M04,8.0,111483,1388255,1276772
Idaho,2016,M10,3.3,26793,819947,793154
Virginia,2004,M01,4.3,163006,3756787,3593781
Texas,2012,M02,7.1,890894,12577948,11687054
Hawaii,2002,M07,4.2,25376,605826,580450
Delaware,2009,M07,8.4,37193,441792,404599
Arizona,2015,M05,5.9,186624,3158989,2972365
Kansas,2004,M03,5.8,84526,1451570,1367044
Texas,2013,M07,6.6,857908,12952255,12094347
Montana,2013,M04,5.5,27911,509922,482011
Vermont,2003,M09,4.1,14284,346494,332210
Kansas,2009,M09,7.2,109120,1514714,1405594
Florida,2013,M10,6.9,651689,9410093,8758404
Delaware,2009,M03,8.2,36451,442612,406161
North Carolina,2009,M08,10.6,485802,4569204,4083402
Michigan,2005,M09,6.2,316086,5082148,4766062
Utah,2014,M05,3.7,52334,1423831,1371497
Montana,2012,M02,7.1,35601,498435,462834
Illinois,2006,M07,4.8,315053,6625691,6310638
Kentucky,2015,M04,4.9,95452,1962062,1866610
Kentucky,2006,M08,5.4,110602,2030606,1920004
California,2004,M02,6.7,1158806,17321488,16162682
Montana,2011,M03,8.1,40445,497035,456590
Illinois,2014,M01,8.9,576267,6485953,5909686
Wyoming,2014,M04,4.3,12986,304608,291622
Tennessee,2003,M10,5.6,161576,2908084,2746508
Arkansas,2007,M04,5.0,68929,1366793,1297864
Michigan,2009,M07,15.4,770692,5012703,4242011
Louisiana,2009,M05,6.5,133213,2058738,1925525
North Dakota,2006,M04,3.3,11856,357956,346100
Kansas,2013,M07,5.9,88919,1508263,1419344
Florida,2010,M11,11.1,1032098,9261907,8229809
Vermont,2015,M07,3.7,12950,351013,338063
Louisiana,2006,M12,3.9,77493,2005019,1927526
Maryland,2006,M11,3.6,108448,2974574,2866126
Ohio,2010,M02,11.9,691096,5831254,5140158
West Virginia,2006,M11,4.3,34840,807680,772840
Vermont,2014,M02,4.4,15351,347497,332146
Oklahoma,2000,M11,2.8,46322,1669957,1623635
Michigan,2010,M02,14.2,686936,4822935,4135999
Wyoming,2001,M07,3.4,9382,274954,265572
Oregon,2016,M04,4.8,98075,2037794,1939719
New Mexico,2016,M11,6.5,60388,935046,874658
Wyoming,2003,M08,3.7,10155,277037,266882
Ohio,2012,M01,8.6,486679,5650325,5163646
Arkansas,2013,M05,7.4,97374,1318492,1221118
New Mexico,2005,M09,4.8,44405,919415,875010
Ohio,2002,M11,5.4,318180,5847069,5528889
Texas,2002,M11,6.4,696834,10824113,10127279
Montana,2001,M10,3.9,18004,462810,444806
New Hampshire,2010,M02,6.9,51207,737437,686230
Utah,2003,M03,6.1,72391,1185555,1113164
Wyoming,2014,M06,4.1,12793,311972,299179
Colorado,2001,M02,3.2,75290,2361740,2286450
California,2011,M06,12.0,2199374,18400547,16201173
Florida,2002,M02,5.7,460374,8062297,7601923
Idaho,2006,M07,2.9,21662,757470,735808
Hawaii,2008,M03,3.2,20264,640953,620689
Oregon,2000,M06,5.0,92300,1834816,1742516
Louisiana,2006,M02,4.5,86875,1945860,1858985
Missouri,2013,M04,6.1,183662,3019748,2836086
Pennsylvania,2003,M07,5.8,363248,6243771,5880523
Missouri,2007,M02,5.4,164900,3026304,2861404
Maryland,2002,M11,4.3,122188,2868530,2746342
Ohio,2005,M06,6.0,354534,5931077,5576543
Arizona,2015,M01,6.5,203876,3136757,2932881
Maryland,2014,M02,6.3,195658,3093285,2897627
Hawaii,2002,M11,3.9,23161,598928,575767
Washington,2016,M08,5.3,193627,3658770,3465143
District of Columbia,2001,M10,6.5,20253,309941,289688
Arizona,2012,M03,8.2,247868,3021250,2773382
North Carolina,2009,M04,10.1,464094,4579675,4115581
Puerto Rico,2005,M03,11.4,155000,1360142,1205142
Pennsylvania,2015,M11,4.7,303387,6409932,6106545
Massachusetts,2014,M06,6.0,214753,3594529,3379776
Illinois,2010,M09,9.4,619794,6595837,5976043
California,2003,M08,6.8,1177265,17287989,16110724
Arkansas,2002,M01,6.4,78925,1233744,1154819
Minnesota,2000,M09,3.0,85999,2825805,2739806
Puerto Rico,2004,M04,11.0,147684,1347231,1199547
Nevada,2006,M07,4.2,54831,1295442,1240611
California,2013,M01,10.2,1903584,18606843,16703259
Delaware,2012,M07,7.4,33237,450342,417105
Oregon,2003,M06,8.6,160782,1865888,1705106
Texas,2007,M09,4.3,496580,11477506,10980926
Puerto Rico,2011,M12,13.4,163741,1217616,1053875
Colorado,2006,M12,3.7,97124,2643988,2546864
Nebraska,2008,M10,3.3,32877,993485,960608
Louisiana,2006,M07,4.5,90534,2014359,1923825
Ohio,2006,M06,5.4,325442,5986147,5660705
Oregon,2009,M10,10.3,202960,1963207,1760247
Oklahoma,2016,M02,4.9,90386,1828032,1737646
Montana,2012,M11,5.5,27881,504592,476711
Ohio,2015,M10,4.3,245071,5693734,5448663
Minnesota,2002,M07,4.4,126510,2892534,2766024
Montana,2011,M11,6.3,31461,499436,467975
Indiana,2002,M04,5.3,167988,3156386,2988398
Hawaii,2013,M05,4.6,29997,645424,615427
Nebraska,2011,M10,4.0,39842,1006701,966859
Kansas,2009,M12,6.8,102329,1502506,1400177
Oregon,2012,M10,8.2,158831,1944525,1785694
California,2011,M01,12.6,2301932,18307227,16005295
Nebraska,2015,M01,3.4,33716,996784,963068
Colorado,2014,M02,6.3,176924,2791365,2614441
Tennessee,2015,M07,6.0,187727,3103741,2916014
Maryland,2005,M12,3.5,103554,2928757,2825203
Louisiana,2008,M03,4.2,85823,2051481,1965658
Colorado,2003,M02,6.3,154117,2457498,2303381
Arizona,2010,M09,10.4,321367,3091190,2769823
Missouri,2001,M10,4.5,133004,2986448,2853444
Kansas,2014,M06,4.9,73397,1512825,1439428
Hawaii,2009,M12,6.8,43038,629473,586435
Rhode Island,2001,M04,4.2,22803,538718,515915
Arizona,2011,M05,9.0,272704,3022263,2749559
Georgia,2002,M08,5.1,220531,4334472,4113941
Montana,2013,M08,4.8,25134,519873,494739
Florida,2003,M04,4.9,401971,8160925,7758954
Idaho,2010,M09,8.0,61009,758664,697655
Michigan,2002,M06,6.7,341598,5079740,4738142
District of Columbia,2006,M10,5.8,18272,317291,299019
Nebraska,2012,M08,3.9,39579,1018965,979386
Alabama,2015,M03,5.9,126437,2139776,2013339
Virginia,2013,M02,6.0,254543,4211683,3957140
Arkansas,2006,M08,5.2,70468,1367380,1296912
Maryland,2012,M02,7.4,227247,3090607,2863360
Louisiana,2014,M02,5.3,109622,2081124,1971502
New York,2010,M02,9.5,905984,9565198,8659214
New Mexico,2011,M07,8.0,74832,936226,861394
Indiana,2005,M12,5.2,166068,3212615,3046547
North Carolina,2007,M02,4.9,219842,4470977,4251135
Washington,2005,M07,5.3,175816,3297504,3121688
Wyoming,2010,M10,5.5,16735,304878,288143
Louisiana,2014,M12,6.4,138042,2170148,2032106
Rhode Island,2010,M11,10.7,60965,567528,506563
Kansas,2006,M08,4.6,66793,1464460,1397667
Washington,2001,M08,6.2,188501,3026210,2837709
Michigan,2011,M04,10.0,462476,4629970,4167494
Arizona,2008,M11,7.4,232414,3142312,2909898
New Mexico,2016,M03,6.6,60404,922098,861694
Georgia,2009,M10,10.5,500170,4779850,4279680
New York,2013,M01,9.1,874915,9615453,8740538
Delaware,2008,M06,4.8,21464,451327,429863
Michigan,2015,M10,4.7,224743,4764107,4539364
Rhode Island,2012,M08,10.2,57543,563738,506195
Massachusetts,2003,M09,5.8,195807,3397959,3202152
Wisconsin,2008,M10,4.5,141038,3100099,2959061
Minnesota,2002,M01,5.4,152924,2834968,2682044
California,2000,M01,5.4,903510,16656950,15753440
Maryland,2016,M03,4.4,139770,3151868,3012098
Michigan,2001,M06,5.1,266101,5177919,4911818
West Virginia,2006,M03,5.2,41256,794993,753737
South Dakota,2016,M10,2.4,11096,454982,443886
Oklahoma,2000,M03,3.2,52736,1654603,1601867
Oregon,2013,M12,7.1,134537,1897907,1763370
Alabama,2015,M08,6.5,139692,2154821,2015129
Ohio,2001,M07,4.2,248925,5872958,5624033
New York,2016,M05,4.3,414684,9566693,9152009
Georgia,2002,M03,5.1,218756,4306139,4087383
Delaware,2000,M12,3.5,14809,422139,407330
Wisconsin,2001,M03,5.1,154917,3010161,2855244
South Carolina,2002,M11,5.9,116031,1950306,1834275
District of Columbia,2001,M09,6.6,20541,310047,289506
Nebraska,2015,M05,2.9,29207,1011138,981931
Connecticut,2005,M10,4.4,79714,1808551,1728837
Oregon,2010,M11,10.1,201381,2000585,1799204
Vermont,2002,M01,4.4,15024,338378,323354
Delaware,2011,M06,7.7,34533,446739,412206
Mississippi,2008,M05,6.5,84969,1316880,1231911
Louisiana,2002,M10,5.9,118078,2015536,1897458
South Dakota,2000,M09,2.1,8331,405543,397212
North Carolina,2001,M03,5.1,214694,4219397,4004703
Rhode Island,2004,M05,5.0,27888,554111,526223
Alaska,2013,M02,7.9,28370,360707,332337
Arizona,2015,M07,6.5,206319,3166235,2959916
Idaho,2015,M05,3.8,30592,797391,766799
Indiana,2011,M06,9.3,298386,3215728,2917342
South Carolina,2004,M07,7.0,143733,2066424,1922691
Louisiana,2001,M02,5.3,107027,2016958,1909931
New Jersey,2000,M07,4.1,175714,4334678,4158964
Louisiana,2001,M10,5.9,119388,2027515,1908127
Florida,2007,M12,4.7,426626,9168288,8741662
South Carolina,2000,M10,3.4,67503,1987061,1919558
Washington,2014,M01,7.0,242220,3445693,3203473
Massachusetts,2013,M06,7.3,258626,3566081,3307455
California,2002,M09,6.3,1087708,17299209,16211501
New Jersey,2008,M01,5.1,228655,4460808,4232153
Maryland,2011,M04,6.9,212075,3071851,2859776
Idaho,2011,M03,9.6,72642,759861,687219
Colorado,2015,M10,3.3,92909,2844996,2752087
Virginia,2008,M08,4.2,173986,4156246,3982260
Alabama,2014,M09,6.3,134825,2151252,2016427
Indiana,2012,M07,8.6,274758,3190593,2915835
Colorado,2011,M01,9.2,250069,2707255,2457186
Wyoming,2004,M07,3.4,9499,280273,270774
Arizona,2016,M04,5.2,167967,3220117,3052150
Virginia,2005,M06,3.8,150857,3934346,3783489
Kansas,2001,M12,4.2,58205,1390028,1331823
Illinois,2004,M01,7.0,441052,6271369,5830317
Arizona,2012,M08,8.9,268240,3029216,2760976
Hawaii,2005,M08,2.8,17612,631461,613849
Louisiana,2009,M07,7.5,158405,2106285,1947880
Kansas,2013,M05,5.3,79139,1481156,1402017
Alabama,2012,M11,6.9,149468,2172786,2023318
Maine,2006,M09,4.1,28600,702383,673783
Nebraska,2000,M07,3.0,28907,960711,931804
Louisiana,2016,M09,6.4,134882,2118949,1984067
Oregon,2011,M07,9.5,191462,2011143,1819681
Utah,2005,M05,4.1,51209,1263001,1211792
Kansas,2014,M12,3.8,57074,1486750,1429676
Iowa,2013,M03,5.3,88026,1661770,1573744
Massachusetts,2005,M04,4.7,156901,3355615,3198714
West Virginia,2007,M09,4.2,33932,817313,783381
Pennsylvania,2012,M12,7.6,487632,6456516,5968884
Oklahoma,2001,M09,3.8,63447,1675974,1612527
Rhode Island,2010,M08,11.3,64596,573911,509315
West Virginia,2002,M03,6.4,51338,796428,745090
Florida,2008,M09,7.1,659033,9280107,8621074
Oklahoma,2004,M03,5.2,86542,1677963,1591421
North Carolina,2008,M10,6.0,276569,4571974,4295405
New Hampshire,2010,M08,5.5,41345,746130,704785
New Mexico,2014,M05,6.5,59817,916584,856767
Virginia,2002,M06,4.4,165001,3755893,3590892
Wisconsin,2010,M07,8.5,264053,3118308,2854255
Indiana,2011,M01,10.0,312687,3140275,2827588
Mississippi,2005,M10,9.1,118761,1312146,1193385
North Carolina,2007,M10,4.5,202372,4527164,4324792
Montana,2015,M03,4.8,24692,514977,490285
Missouri,2010,M04,9.3,286167,3074415,2788248
Wisconsin,2006,M02,5.8,174406,3030489,2856083
Mississippi,2000,M10,5.0,65369,1310878,1245509
California,2001,M11,6.2,1063627,17187735,16124108
Alabama,2015,M11,5.7,122954,2158183,2035229
Georgia,2001,M11,4.6,195499,4276853,4081354
Rhode Island,2007,M07,5.5,31744,581130,549386
Nevada,2001,M03,4.8,53359,1102159,1048800
Arkansas,2012,M05,7.5,101047,1355516,1254469
West Virginia,2006,M04,4.9,39610,803084,763474
Oregon,2008,M12,9.1,178997,1967360,1788363
Oklahoma,2000,M04,2.6,43009,1655331,1612322
Virginia,2003,M02,4.5,166729,3736876,3570147
Indiana,2016,M10,3.9,130358,3328690,3198332
Minnesota,2003,M10,4.4,125373,2881125,2755752
Virginia,2014,M10,4.8,203932,4238937,4035005
Florida,2004,M03,4.7,388409,8334461,7946052
Wyoming,2016,M02,5.9,17593,299963,282370
Kentucky,2002,M07,5.6,109355,1952516,1843161
Minnesota,2009,M07,7.9,234863,2980468,2745605
Iowa,2003,M09,4.2,66541,1593659,1527118
Minnesota,2007,M05,4.1,118504,2899070,2780566
Colorado,2011,M03,8.9,242514,2717143,2474629
Colorado,2014,M10,4.0,113630,2831505,2717875
Connecticut,2009,M07,8.3,160155,1928440,1768285
Wyoming,2004,M01,4.9,13403,271654,258251
New Mexico,2013,M11,6.8,62740,926861,864121
Virginia,2006,M12,2.8,110712,4004916,3894204
West Virginia,2012,M12,7.3,58062,799724,741662
Tennessee,2005,M10,5.0,148148,2944509,2796361
Oregon,2012,M02,9.8,193318,1967235,1773917
Oklahoma,2010,M12,6.3,110491,1762580,1652089
Iowa,2001,M11,3.4,55130,1624342,1569212
Mississippi,2015,M08,5.9,75153,1267602,1192449
Tennessee,2000,M09,3.8,105589,2814077,2708488
Nebraska,2011,M02,4.9,48709,992378,943669
New Hampshire,2011,M09,5.2,38151,733459,695308
Kentucky,2013,M08,7.9,160966,2047448,1886482
Utah,2015,M03,3.8,55318,1450536,1395218
New Hampshire,2014,M03,4.9,36547,740221,703674
New Jersey,2016,M02,5.3,241938,4523008,4281070
Minnesota,2014,M12,3.8,111260,2954326,2843066
Indiana,2014,M09,5.3,172366,3222842,3050476
West Virginia,2008,M05,4.3,34978,817134,782156
Delaware,2011,M12,6.7,30066,446381,416315
Georgia,2002,M11,4.8,211269,4358819,4147550
South Carolina,2015,M06,6.3,146163,2303608,2157445
Oklahoma,2014,M05,4.6,81510,1780253,1698743
Wyoming,2008,M08,2.6,7820,296658,288838
New Mexico,2010,M10,7.7,72305,936646,864341
South Carolina,2016,M02,5.4,124139,2278246,2154107
Virginia,2014,M09,5.1,214918,4226366,4011448
Wyoming,2006,M06,3.2,9162,287086,277924
Washington,2000,M07,5.1,155901,3077981,2922080
Washington,2012,M02,9.4,326271,3476072,3149801
Montana,2003,M06,4.7,22633,477091,454458
California,2014,M07,7.9,1492642,18849631,17356989
Alabama,2003,M10,6.1,130045,2139347,2009302
New Mexico,2002,M01,5.6,48156,858753,810597
Georgia,2004,M02,4.2,185492,4401350,4215858
Mississippi,2001,M12,6.5,84539,1294894,1210355
Mississippi,2012,M05,8.9,118634,1326260,1207626
Tennessee,2012,M02,8.2,252567,3084931,2832364
North Dakota,2007,M09,2.5,9159,366816,357657
Kansas,2011,M10,6.0,89777,1491827,1402050
Rhode Island,2000,M05,3.9,20927,539826,518899
Ohio,2001,M01,4.5,260269,5775219,5514950
Iowa,2013,M11,4.0,68172,1686609,1618437
Puerto Rico,2001,M03,10.7,135655,1263479,1127824
District of Columbia,2005,M01,7.8,24565,316069,291504
Washington,2002,M12,7.4,227670,3092317,2864647
Alaska,2010,M10,7.3,26229,360922,334693
Utah,2004,M03,5.6,67507,1214002,1146495
Arizona,2003,M10,5.5,150758,2759730,2608972
Montana,2014,M09,3.8,19510,513040,493530
Wisconsin,2006,M11,4.3,131184,3070798,2939614
North Carolina,2011,M05,10.1,469114,4648647,4179533
New York,2001,M02,4.7,431863,9142525,8710662
South Carolina,2012,M06,9.8,217906,2225686,2007780
Florida,2002,M10,5.3,436226,8179472,7743246
Washington,2005,M05,5.4,176960,3247714,3070754
Massachusetts,2006,M06,5.1,175370,3457695,3282325
Pennsylvania,2004,M02,6.0,371469,6146720,5775251
Nebraska,2002,M11,3.3,31502,954546,923044
Puerto Rico,2003,M02,12.5,168094,1341867,1173773
Montana,2000,M06,4.9,23205,474260,451055
Kansas,2006,M12,3.9,57082,1473128,1416046
Alaska,2016,M07,6.1,22540,371272,348732
Georgia,2001,M08,4.2,179696,4229318,4049622
Virginia,2000,M03,2.6,94113,3604095,3509982
Iowa,2013,M06,4.9,82159,1693098,1610939
Vermont,2012,M09,4.8,16946,354129,337183
Idaho,2000,M07,4.1,27457,669020,641563
Arkansas,2005,M08,5.2,70528,1356907,1286379
Delaware,2005,M09,4.1,17866,433196,415330
Oregon,2006,M08,5.2,99093,1912378,1813285
Tennessee,2001,M03,4.3,122717,2860936,2738219
Oregon,2010,M12,10.0,197501,1984603,1787102
Texas,2016,M04,4.3,564001,13236855,12672854
Missouri,2005,M09,4.9,146951,2996983,2850032
Utah,2014,M09,3.5,49744,1434147,1384403
Massachusetts,2014,M08,5.7,206301,3602980,3396679
Maryland,2008,M09,4.5,135775,3009506,2873731
Minnesota,2005,M08,3.4,98758,2893574,2794816
Michigan,2006,M06,7.1,365913,5134303,4768390
Kentucky,2003,M10,5.4,106312,1956427,1850115
Hawaii,2014,M06,5.0,33648,670085,636437
Washington,2002,M03,8.0,246766,3069399,2822633
Minnesota,2011,M06,6.8,200743,2970660,2769917
California,2016,M07,5.8,1115050,19209227,18094177
North Carolina,2000,M07,3.8,159085,4174027,4014942
West Virginia,2014,M12,6.0,46600,772321,725721
Oklahoma,2008,M12,4.5,78568,1756954,1678386
Hawaii,2004,M08,3.2,19770,612722,592952
Maine,2001,M04,4.0,26917,667105,640188
Delaware,2009,M04,8.1,35716,441968,406252
Kansas,2010,M02,7.5,111764,1496477,1384713
New Mexico,2011,M11,7.3,68229,934854,866625
North Dakota,2008,M05,2.7,10008,373569,363561
Idaho,2006,M02,5.0,36904,741822,704918
Rhode Island,2000,M10,3.6,19685,544311,524626
Alabama,2012,M08,8.5,185611,2177294,1991683
Wisconsin,2004,M06,5.3,162852,3079882,2917030
Rhode Island,2004,M07,5.5,30880,566474,535594
Illinois,2011,M10,9.6,633683,6618191,5984508
Idaho,2001,M05,4.5,30455,676751,646296
Rhode Island,2001,M12,4.3,23361,544760,521399
Iowa,2003,M08,4.4,69548,1597420,1527872
District of Columbia,2004,M10,8.2,26019,315710,289691
Pennsylvania,2015,M03,5.6,355079,6376420,6021341
Vermont,2002,M03,4.5,15291,340809,325518
Iowa,2005,M07,4.0,65585,1651829,1586244
Alabama,2005,M04,3.9,83119,2128189,2045070
District of Columbia,2007,M12,5.5,17832,324961,307129
Puerto Rico,2015,M10,14.1,161397,1142110,980713
North Carolina,2016,M08,5.3,255587,4867507,4611920
Minnesota,2006,M01,5.0,142762,2873024,2730262
Arkansas,2007,M09,5.1,70503,1370380,1299877
Vermont,2006,M08,3.5,12456,361037,348581
Hawaii,2010,M01,7.2,45573,633059,587486
Michigan,2005,M06,6.9,355852,5141253,4785401
Florida,2016,M07,5.1,508776,9879776,9371000
Maryland,2010,M12,7.2,222407,3077097,2854690
Washington,2012,M10,7.2,249724,3479546,3229822
Washington,2009,M01,7.9,275336,3496935,3221599
Arkansas,2002,M03,5.7,72382,1263167,1190785
Indiana,2005,M04,5.3,168110,3186840,3018730
Kentucky,2001,M02,5.3,103444,1955029,1851585
Hawaii,2010,M12,6.4,41825,656944,615119
New Mexico,2010,M02,8.1,75482,929658,854176
Maryland,2015,M06,5.4,170044,3178177,3008133
Louisiana,2014,M04,5.1,108507,2115062,2006555
Minnesota,2013,M03,5.7,167973,2940398,2772425
California,2012,M06,10.6,1976656,18564592,16587936
Delaware,2003,M12,3.5,14721,418265,403544
Georgia,2006,M03,4.5,211133,4655686,4444553
Missouri,2006,M06,4.9,149146,3063932,2914786
Wisconsin,2005,M03,5.5,165230,2989760,2824530
Virginia,2015,M12,3.9,161126,4172390,4011264
Wisconsin,2007,M06,5.1,161386,3136599,2975213
Wisconsin,2008,M09,4.3,133618,3089165,2955547
Alaska,2012,M07,6.5,24262,375658,351396
Washington,2014,M08,6.0,209485,3502870,3293385
Nevada,2012,M05,11.2,153618,1376253,1222635
North Carolina,2007,M11,4.6,210058,4544457,4334399
Ohio,2012,M04,7.0,394084,5669380,5275296
Missouri,2016,M03,4.8,151038,3118733,2967695
Wyoming,2005,M05,3.5,9571,274770,265199
Alabama,2010,M02,12.1,258825,2135583,1876758
Kentucky,2006,M10,4.9,99171,2031681,1932510
Oklahoma,2007,M07,4.2,73866,1741929,1668063
West Virginia,2001,M07,4.6,37385,817898,780513
New Jersey,2009,M01,8.0,360677,4502539,4141862
Rhode Island,2010,M02,11.9,66801,563426,496625
Louisiana,2000,M08,5.8,117854,2036301,1918447
Wyoming,2010,M09,5.3,16075,303557,287482
Alabama,2004,M07,6.0,128010,2147973,2019963
Massachusetts,2009,M06,8.3,293594,3524377,3230783
Arkansas,2009,M03,7.8,106319,1360602,1254283
Montana,2015,M12,4.4,22598,519002,496404
Maryland,2012,M06,7.3,231056,3149073,2918017
California,2006,M10,4.5,790341,17752680,16962339
Louisiana,2005,M09,10.9,230825,2112064,1881239
Idaho,2007,M03,3.8,28200,749821,721621
Illinois,2008,M06,6.7,451337,6767021,6315684
Wisconsin,2003,M04,6.0,183359,3045324,2861965
Minnesota,2006,M03,4.7,135929,2877113,2741184
North Carolina,2015,M12,5.2,248697,4767426,4518729
Vermont,2010,M10,5.1,18244,358767,340523
Connecticut,2006,M09,4.2,77363,1827708,1750345
Vermont,2014,M07,4.0,14186,353424,339238
District of Columbia,2010,M12,9.3,32052,345611,313559
Nebraska,2005,M08,3.5,34480,974480,940000
West Virginia,2012,M11,7.0,56176,804246,748070
Colorado,2002,M08,5.4,133192,2466027,2332835
Colorado,2000,M04,2.5,59760,2346499,2286739
Oklahoma,2010,M11,6.5,115176,1776554,1661378
Alaska,2006,M03,7.5,25979,345082,319103
Mississippi,2001,M11,6.1,78454,1285787,1207333
Indiana,2007,M08,4.4,141131,3197853,3056722
District of Columbia,2003,M10,6.8,20982,306468,285486
Utah,2011,M01,7.9,106568,1348130,1241562
Arkansas,2014,M07,6.5,85295,1318038,1232743
Illinois,2007,M01,5.2,343853,6573417,6229564
Oregon,2006,M09,4.6,88021,1897517,1809496
Maryland,2000,M10,3.4,97146,2819569,2722423
New Hampshire,2009,M08,6.2,46720,751173,704453
Utah,2000,M08,3.7,43053,1153052,1109999
Virginia,2013,M06,6.1,260295,4281069,4020774
Nebraska,2013,M09,3.4,34435,1009193,974758
Missouri,2013,M10,6.0,179397,3003218,2823821
District of Columbia,2013,M11,8.0,29761,372500,342739
Arizona,2005,M09,4.8,139507,2912411,2772904
Ohio,2015,M09,4.3,245460,5651677,5406217
Illinois,2015,M06,6.0,398300,6591348,6193048
Indiana,2011,M08,9.4,302056,3199431,2897375
Massachusetts,2004,M07,5.3,182638,3446380,3263742
Missouri,2014,M10,4.9,151872,3077487,2925615
West Virginia,2014,M03,7.5,59416,788689,729273
Oklahoma,2008,M03,3.3,56234,1721513,1665279
New Hampshire,2005,M01,4.1,29686,719418,689732
Nevada,2002,M04,5.8,64737,1124468,1059731
Virginia,2004,M04,3.6,136632,3772672,3636040
Georgia,2007,M09,4.7,226514,4836881,4610367
Arizona,2007,M07,4.0,121726,3038360,2916634
Idaho,2008,M12,7.0,52449,750617,698168
Mississippi,2001,M01,5.5,71620,1303109,1231489
Tennessee,2016,M01,4.8,148116,3070950,2922834
Massachusetts,2008,M11,6.1,210847,3471972,3261125
Florida,2000,M04,3.3,254983,7809886,7554903
Oregon,2010,M03,11.9,233665,1970893,1737228
Iowa,2006,M01,4.7,75749,1628680,1552931
Montana,2004,M07,4.3,21172,492149,470977
Rhode Island,2008,M02,7.2,40690,567968,527278
North Carolina,2013,M08,7.9,368656,4672653,4303997
Virginia,2010,M06,7.2,300365,4185757,3885392
Arizona,2012,M06,8.9,270045,3043976,2773931
Georgia,2005,M07,5.6,260412,4621192,4360780
South Carolina,2014,M03,6.0,130605,2192122,2061517
California,2003,M10,6.5,1125283,17312391,16187108
Kentucky,2000,M06,4.2,83395,1992902,1909507
Nevada,2013,M03,10.1,140015,1380144,1240129
South Carolina,2011,M09,10.7,232937,2185449,1952512
Florida,2002,M11,5.4,438827,8111399,7672572
Iowa,2007,M01,4.5,74553,1646977,1572424
Wyoming,2011,M03,6.6,20270,304846,284576
Illinois,2000,M11,4.2,269738,6460420,6190682
Nebraska,2011,M04,4.3,43507,1001678,958171
South Dakota,2007,M07,2.6,11680,453320,441640
Mississippi,2012,M07,9.8,131342,1333937,1202595
Ohio,2005,M03,6.5,379969,5829381,5449412
New Hampshire,2001,M07,3.5,24699,710758,686059
Missouri,2007,M11,5.0,150370,3030163,2879793
Maine,2015,M01,5.9,39879,678213,638334
Utah,2015,M01,3.9,56921,1444641,1387720
Illinois,2012,M06,9.4,629340,6684556,6055216
Montana,2007,M08,3.4,17443,512597,495154
District of Columbia,2016,M08,6.4,24968,391268,366300
Missouri,2010,M12,9.2,279008,3039486,2760478
Wyoming,2011,M08,5.0,15524,309004,293480
Utah,2002,M04,5.7,66516,1172502,1105986
Hawaii,2011,M11,6.9,45413,656819,611406
Florida,2010,M12,10.7,989605,9236076,8246471
New Hampshire,2002,M03,4.8,33765,698459,664694
Indiana,2010,M02,11.8,373103,3149825,2776722
Arkansas,2010,M05,8.0,108847,1359528,1250681
West Virginia,2006,M12,4.2,33382,801726,768344
Oklahoma,2000,M12,2.6,43807,1662288,1618481
Pennsylvania,2011,M01,8.6,547854,6346875,5799021
Alaska,2002,M02,8.0,25827,321362,295535
Mississippi,2015,M05,6.8,86318,1276527,1190209
Hawaii,2003,M02,3.7,21967,599624,577657
Kansas,2000,M08,3.8,53050,1396104,1343054
California,2005,M04,5.3,933072,17453180,16520108
Idaho,2016,M04,3.9,31401,807610,776209
Maryland,2010,M11,7.4,229332,3086876,2857544
Louisiana,2005,M10,10.6,223440,2104270,1880830
South Carolina,2001,M07,5.4,106394,1973531,1867137
Maine,2011,M03,9.0,61963,690851,628888
Mississippi,2010,M02,11.3,142200,1260039,1117839
Indiana,2012,M06,8.4,270647,3206013,2935366
Hawaii,2010,M11,6.9,45655,657743,612088
Washington,2004,M05,6.1,194546,3175900,2981354
South Carolina,2004,M04,6.3,126604,2018952,1892348
Iowa,2001,M10,3.0,49497,1624684,1575187
Wyoming,2001,M05,3.6,9554,268016,258462
District of Columbia,2009,M01,8.3,27690,331629,303939
New Hampshire,2014,M12,3.7,27290,738275,710985
Ohio,2006,M11,5.2,309349,5999253,5689904
Maryland,2001,M07,4.1,116802,2878407,2761605
Ohio,2009,M11,10.3,604317,5865681,5261364
New Hampshire,2009,M03,6.7,49958,745490,695532
Pennsylvania,2001,M12,5.0,311767,6182038,5870271
Montana,2011,M06,7.0,35497,507452,471955
Missouri,2002,M07,5.7,172296,3021008,2848712
Alabama,2016,M03,6.0,129417,2160907,2031490
Alaska,2014,M09,6.2,22747,366000,343253
Utah,2001,M04,4.0,45948,1151573,1105625
Oregon,2003,M11,7.5,138966,1845255,1706289
Nevada,2013,M01,10.8,149291,1378629,1229338
South Dakota,2008,M08,3.0,13707,452960,439253
New York,2008,M09,5.5,535656,9675830,9140174
Nevada,2009,M10,12.0,161372,1343292,1181920
Louisiana,2008,M07,5.2,111073,2124869,2013796
Idaho,2013,M02,7.5,57097,764998,707901
Connecticut,2009,M01,7.3,137216,1871420,1734204
Utah,2012,M12,4.8,66262,1386784,1320522
Washington,2015,M08,5.4,190266,3547754,3357488
Nebraska,2005,M03,4.2,40265,970226,929961
New Jersey,2006,M10,3.9,174728,4439900,4265172
Ohio,2002,M01,6.4,370821,5782677,5411856
Montana,2003,M11,4.8,22471,470761,448290
Alaska,2008,M10,6.3,22324,354710,332386
North Carolina,2000,M09,3.5,144757,4128711,3983954
Minnesota,2006,M08,3.5,102772,2899021,2796249
Virginia,2004,M03,4.2,157612,3774268,3616656
California,2016,M09,5.2,1004338,19186046,18181708
Connecticut,2000,M11,1.9,32516,1755962,1723446
Maryland,2004,M05,4.1,117712,2873038,2755326
Nevada,2010,M12,13.6,185477,1363038,1177561
Maryland,2013,M12,5.8,178844,3098011,2919167
Indiana,2006,M04,5.0,162804,3225772,3062968
Iowa,2014,M05,3.9,66578,1698828,1632250
Montana,2008,M06,5.0,25559,516190,490631
Louisiana,2001,M04,5.1,104042,2028828,1924786
West Virginia,2000,M10,4.8,38575,810421,771846
Oklahoma,2006,M10,3.9,66742,1726929,1660187
Hawaii,2007,M07,2.9,18843,642807,623964
California,2002,M07,6.9,1194605,17299208,16104603
District of Columbia,2010,M02,9.9,33674,341382,307708
California,2007,M04,5.0,895083,17758831,16863748
Oregon,2000,M11,4.8,88244,1822454,1734210
Arizona,2012,M05,8.3,249605,3024215,2774610
Rhode Island,2003,M05,5.1,28645,557118,528473
Texas,2014,M07,5.6,730679,13079413,12348734
North Dakota,2014,M01,3.5,13961,403859,389898
Delaware,2012,M05,6.8,30296,444668,414372
Washington,2014,M03,6.7,232799,3477011,3244212
Michigan,2006,M09,6.7,339071,5054077,4715006
Nevada,2005,M09,4.1,50456,1236271,1185815
Wyoming,2006,M02,3.7,10188,275629,265441
Montana,2007,M11,3.9,19765,503090,483325
Alaska,2006,M01,7.9,27154,343252,316098
Georgia,2006,M01,4.9,225969,4625588,4399619
South Carolina,2006,M04,6.1,128541,2101886,1973345
Oregon,2011,M01,10.7,212194,1981882,1769688
Wisconsin,2005,M01,5.5,163676,2991845,2828169
Michigan,2014,M06,7.6,365975,4813468,4447493
Connecticut,2004,M11,4.5,79774,1777384,1697610
Rhode Island,2002,M11,4.6,25782,556972,531190
Colorado,2007,M09,3.5,94629,2693063,2598434
New Jersey,2010,M06,9.3,428868,4594818,4165950
Colorado,2010,M10,8.4,230527,2730669,2500142
Arkansas,2002,M08,5.2,66060,1278252,1212192
Vermont,2006,M03,4.2,14975,355773,340798
Tennessee,2004,M03,5.6,160772,2873349,2712577
Missouri,2002,M12,5.2,154755,2995090,2840335
Hawaii,2011,M01,6.9,45301,660206,614905
Indiana,2005,M11,5.3,171759,3228217,3056458
New York,2001,M06,4.3,396872,9184302,8787430
North Dakota,2010,M03,4.8,17760,372538,354778
Oregon,2013,M01,9.4,178924,1898522,1719598
Wisconsin,2012,M06,7.5,235312,3125920,2890608
Missouri,2015,M04,5.2,160559,3111317,2950758
Michigan,2015,M04,5.1,240120,4707115,4466995
Wyoming,2015,M04,4.2,12692,304429,291737
New York,2004,M08,5.3,502791,9460007,8957216
Washington,2005,M03,6.0,194626,3233053,3038427
District of Columbia,2013,M12,7.6,28350,371429,343079
Ohio,2005,M10,5.3,315153,5928924,5613771
Maryland,2013,M04,6.4,198469,3108802,2910333
Utah,2003,M04,5.6,66683,1185510,1118827
New Mexico,2006,M09,4.1,38043,929891,891848
Michigan,2013,M06,9.6,463865,4816137,4352272
West Virginia,2003,M10,5.1,39777,785897,746120
Oklahoma,2005,M10,4.0,69238,1718204,1648966
North Carolina,2007,M04,4.5,201393,4484842,4283449
Maine,2013,M12,6.0,42174,700471,658297
Arkansas,2014,M05,6.1,79057,1302035,1222978
Florida,2000,M05,3.6,280011,7825869,7545858
Rhode Island,2006,M11,4.3,24570,576438,551868
New Jersey,2001,M02,4.1,172863,4255915,4083052
California,2007,M12,5.9,1056279,18013783,16957504
Rhode Island,2005,M11,4.6,26093,571348,545255
Maryland,2007,M06,3.7,111637,2995741,2884104
Michigan,2000,M08,3.7,193610,5176326,4982716
South Carolina,2003,M04,6.3,125403,1987345,1861942
Ohio,2008,M04,5.3,314429,5924449,5610020
Idaho,2012,M10,6.2,48049,771366,723317
District of Columbia,2008,M02,5.9,19338,327803,308465
Michigan,2006,M07,8.1,417905,5144210,4726305
Georgia,2000,M05,3.7,155898,4219745,4063847
Wisconsin,2015,M06,4.8,151802,3135247,2983445
Puerto Rico,2005,M01,10.8,145443,1346044,1200601
Arkansas,2005,M03,5.3,70431,1326100,1255669
Idaho,2002,M05,5.0,33826,683006,649180
Delaware,2000,M03,3.9,15718,408123,392405
Florida,2009,M10,11.1,1003589,9053870,8050281
Connecticut,2007,M02,4.7,86083,1829784,1743701
Virginia,2000,M08,2.4,85585,3603124,3517539
Minnesota,2002,M03,5.4,154484,2850991,2696507
Washington,2015,M09,5.2,183876,3545691,3361815
Montana,2001,M08,3.9,18505,472490,453985
Virginia,2013,M05,5.7,242434,4267513,4025079
South Carolina,2009,M08,11.5,247965,2162652,1914687
Iowa,2013,M07,4.6,78335,1702595,1624260
Minnesota,2015,M09,3.2,94583,2964314,2869731
Massachusetts,2001,M06,3.8,130288,3419715,3289427
South Carolina,2005,M11,6.9,143139,2081206,1938067
Michigan,2007,M12,7.1,354672,4977778,4623106
Maryland,2004,M06,4.6,132821,2912720,2779899
California,2011,M12,11.0,2037162,18469288,16432126
Montana,2016,M04,4.1,21382,524095,502713
Kansas,2010,M07,7.4,112315,1522101,1409786
Pennsylvania,2011,M05,7.7,494909,6391965,5897056
Missouri,2001,M06,4.6,139052,3041046,2901994
Kansas,2014,M10,4.0,59135,1494215,1435080
Vermont,2016,M02,3.6,12454,342735,330281
Maryland,2009,M08,7.2,218821,3052461,2833640
Pennsylvania,2010,M09,7.7,490746,6372978,5882232
Florida,2001,M04,3.9,316028,8013365,7697337
Wyoming,2013,M04,5.1,15457,304429,288972
Virginia,2009,M06,7.0,290063,4163186,3873123
Puerto Rico,2006,M11,9.9,140175,1420182,1280007
Nevada,2016,M04,5.9,83327,1420601,1337274
Arizona,2000,M08,4.5,113626,2504916,2391290
Oregon,2003,M12,7.4,134861,1828065,1693204
Connecticut,2007,M11,4.5,84960,1872451,1787491
Idaho,2016,M06,3.7,30153,824595,794442
Hawaii,2015,M04,3.6,24322,673199,648877
Missouri,2006,M02,5.6,166981,2995665,2828684
Utah,2013,M10,4.2,58898,1418546,1359648
Utah,2008,M01,3.3,45315,1366840,1321525
Hawaii,2012,M10,5.5,35258,642093,606835
Indiana,2001,M02,4.0,124699,3124626,2999927
Ohio,2011,M02,9.8,559437,5737769,5178332
Michigan,2009,M04,12.8,623239,4877204,4253965
California,2015,M07,6.5,1235142,18973393,17738251
Vermont,2015,M02,4.1,14022,344755,330733
Texas,2009,M10,8.1,975533,11987128,11011595
Rhode Island,2012,M09,9.6,53888,559532,505644
Illinois,2007,M06,5.2,353592,6750160,6396568
South Dakota,2009,M08,4.7,21292,449651,428359
Hawaii,2009,M10,7.2,45288,626047,580759
Illinois,2012,M04,8.3,543290,6513532,5970242
Tennessee,2015,M01,6.6,200000,3041097,2841097
Pennsylvania,2004,M07,5.6,357020,6322860,5965840
Puerto Rico,2014,M11,13.6,154028,1132106,978078
Arizona,2008,M06,6.1,191462,3113462,2922000
Indiana,2007,M01,5.4,175076,3212980,3037904
Colorado,2007,M08,3.6,96489,2683856,2587367
Utah,2015,M08,3.7,54724,1474284,1419560
Montana,2016,M02,5.0,26156,519664,493508
Michigan,2004,M08,6.7,340086,5089657,4749571
Colorado,2010,M05,8.5,231059,2713397,2482338
Kansas,2004,M09,5.3,77035,1463346,1386311
Minnesota,2008,M10,5.2,152922,2937938,2785016
Wyoming,2015,M03,4.5,13727,304636,290909
Tennessee,2005,M11,5.3,156807,2946397,2789590
Tennessee,2006,M11,4.6,143499,3088308,2944809
Kansas,2009,M03,6.5,98607,1509827,1411220
Ohio,2001,M03,4.1,239645,5795795,5556150
District of Columbia,2014,M05,7.2,26917,371773,344856
Maine,2003,M01,5.6,37864,670619,632755
Illinois,2015,M08,5.8,375797,6519472,6143675
Kentucky,2008,M06,6.5,133469,2063861,1930392
Wisconsin,2001,M10,4.1,122940,3006628,2883688
Delaware,2015,M07,5.0,23658,473173,449515
Kansas,2014,M05,4.5,67700,1491171,1423471
Delaware,2011,M10,7.2,31781,444468,412687
Arizona,2011,M06,10.5,321949,3056961,2735012
Kansas,2002,M11,4.9,69807,1423718,1353911
Nebraska,2012,M10,3.6,36954,1018098,981144
Nebraska,2011,M12,4.2,42053,1005695,963642
Wisconsin,2008,M05,4.3,130599,3072305,2941706
Georgia,2007,M08,4.6,222985,4806223,4583238
Connecticut,2015,M01,6.7,125349,1880616,1755267
South Dakota,2015,M01,3.9,17152,442333,425181
Missouri,2009,M11,9.3,283064,3035245,2752181
Wyoming,2014,M10,3.7,11213,306735,295522
Mississippi,2011,M08,9.8,131074,1335131,1204057
Oregon,2007,M10,4.8,92230,1936250,1844020
Indiana,2004,M05,5.1,160183,3167139,3006956
Puerto Rico,2013,M10,14.7,171363,1164256,992893
Montana,2011,M05,6.6,32955,500803,467848
Texas,2005,M11,5.3,592268,11256833,10664565
Arkansas,2012,M07,8.0,109408,1360398,1250990
Tennessee,2002,M11,4.8,139872,2905501,2765629
Arkansas,2003,M08,5.9,74914,1273160,1198246
Wyoming,2005,M09,3.2,8933,277686,268753
Maryland,2013,M02,7.1,222053,3110133,2888080
Arizona,2007,M06,3.8,116406,3034911,2918505
Iowa,2011,M04,5.3,88423,1663749,1575326
Montana,2012,M07,5.5,28705,518142,489437
Minnesota,2002,M11,3.9,112775,2859389,2746614
Massachusetts,2016,M06,4.0,145385,3628844,3483459
Vermont,2009,M02,7.1,25706,359707,334001
Michigan,2016,M06,5.2,251290,4877133,4625843
South Carolina,2011,M06,11.1,245228,2210838,1965610
Ohio,2009,M04,9.9,582281,5903890,5321609
New Hampshire,2000,M04,2.6,17451,679868,662417
Nevada,2015,M02,7.3,102204,1409222,1307018
Wyoming,2012,M08,4.8,14877,309559,294682
Nebraska,2003,M10,3.6,34439,965164,930725
Texas,2000,M03,4.6,473019,10373466,9900447
Wyoming,2009,M02,5.5,16099,294997,278898
West Virginia,2007,M08,4.6,37303,814483,777180
Oklahoma,2001,M08,3.8,63076,1670192,1607116
Alabama,2009,M09,11.5,246302,2146406,1900104
Wisconsin,2012,M01,7.9,239014,3042800,2803786
Hawaii,2005,M03,2.8,17607,620494,602887
Nebraska,2000,M04,2.7,25214,944424,919210
Virginia,2009,M05,6.7,276611,4148493,3871882
Kansas,2007,M08,4.3,64089,1480012,1415923
Montana,2015,M04,4.0,20534,516620,496086
South Dakota,2002,M12,3.2,13534,416451,402917
Alabama,2010,M08,10.1,224435,2212696,1988261
South Carolina,2006,M02,6.8,141100,2077779,1936679
Texas,2006,M11,4.4,506468,11431818,10925350
Illinois,2015,M09,5.4,347170,6475132,6127962
South Carolina,2008,M06,6.6,143842,2172319,2028477
Ohio,2000,M09,3.7,213002,5763168,5550166
Mississippi,2007,M02,6.6,85850,1291659,1205809
Texas,2015,M05,4.3,563808,13069992,12506184
Maine,2005,M09,4.4,30619,701252,670633
Montana,2010,M02,8.4,41746,495066,453320
Nevada,2011,M10,12.5,171639,1375870,1204231
Arizona,2003,M03,5.7,154611,2710876,2556265
Massachusetts,2003,M10,5.2,178220,3409437,3231217
New Jersey,2004,M10,4.2,181546,4330372,4148826
Nebraska,2007,M07,3.3,32698,996771,964073
Louisiana,2004,M03,5.9,118089,2014582,1896493
Rhode Island,2006,M12,4.3,24831,575432,550601
Montana,2004,M06,4.8,23653,488972,465319
California,2007,M11,5.6,1011518,18031591,17020073
West Virginia,2004,M09,4.4,34738,783609,748871
Oklahoma,2002,M09,4.4,74543,1683749,1609206
Connecticut,2007,M03,4.4,80143,1836206,1756063
Virginia,2010,M07,7.1,299948,4205051,3905103
Michigan,2002,M02,6.7,337731,5027200,4689469
Washington,2003,M04,7.5,231205,3101351,2870146
Kentucky,2001,M08,5.2,100606,1945670,1845064
Wyoming,2006,M05,3.1,8574,279544,270970
North Dakota,2002,M01,4.4,14699,333692,318993
Delaware,2010,M12,7.6,33552,438896,405344
Arizona,2006,M02,4.4,128577,2944162,2815585
West Virginia,2006,M07,5.2,42361,816844,774483
Oklahoma,2000,M07,3.0,50672,1670592,1619920
Montana,2003,M10,4.3,20216,471788,451572
Ohio,2016,M08,4.8,278828,5754445,5475617
Oregon,2016,M09,4.6,95099,2075688,1980589
Florida,2010,M05,10.5,965840,9226168,8260328
New Jersey,2014,M02,7.7,343160,4480884,4137724
District of Columbia,2004,M11,8.1,25717,316396,290679
Louisiana,2003,M08,6.9,138970,2021583,1882613
Maryland,2003,M07,4.6,135124,2938792,2803668
Massachusetts,2004,M04,5.1,170379,3373756,3203377
Georgia,2002,M01,5.2,222112,4262015,4039903
Vermont,2011,M05,5.3,19040,356283,337243
South Carolina,2002,M04,5.5,105923,1941768,1835845
Minnesota,2001,M08,3.5,100492,2856110,2755618
Wisconsin,2001,M01,4.5,133204,2988851,2855647
Missouri,2010,M07,9.8,301805,3085690,2783885
Maryland,2004,M01,4.7,134472,2867125,2732653
Kansas,2001,M05,3.8,51787,1379739,1327952
Nevada,2007,M04,4.3,56625,1320830,1264205
Illinois,2005,M07,5.8,376475,6485303,6108828
Idaho,2015,M09,3.7,29994,800079,770085
Maine,2005,M04,5.2,35714,687009,651295
Delaware,2013,M04,6.9,30559,441144,410585
Hawaii,2000,M08,4.2,25414,604869,579455
Michigan,2013,M05,8.8,417996,4759456,4341460
District of Columbia,2015,M12,6.2,24094,389065,364971
Nevada,2013,M12,8.6,117883,1376882,1258999
Georgia,2008,M01,5.3,257418,4883805,4626387
Arkansas,2015,M07,5.5,73734,1351326,1277592
Indiana,2007,M10,4.0,129841,3206343,3076502
Wisconsin,2008,M06,4.8,148855,3133022,2984167
Missouri,2011,M04,8.2,251151,3049205,2798054
South Carolina,2004,M02,7.0,140383,1995185,1854802
Maryland,2002,M01,5.1,143883,2844305,2700422
Arizona,2015,M11,5.6,178770,3195136,3016366
Nebraska,2015,M08,3.1,31049,1012637,981588
Alabama,2008,M03,4.7,101104,2170499,2069395
West Virginia,2015,M12,5.9,45944,773280,727336
Illinois,2016,M05,5.3,342972,6516889,6173917
Minnesota,2011,M04,6.6,194420,2936267,2741847
Oklahoma,2009,M12,6.7,117339,1746836,1629497
Maine,2008,M05,5.1,35279,697933,662654
Washington,2000,M04,4.8,146424,3060235,2913811
Mississippi,2010,M04,9.8,124204,1261013,1136809
California,2012,M12,9.6,1782183,18579709,16797526
Arizona,2010,M04,10.1,315212,3113311,2798099
North Dakota,2007,M08,2.8,10591,372788,362197
New York,2009,M06,8.4,820334,9758674,8938340
New Hampshire,2012,M09,5.3,38849,739532,700683
District of Columbia,2007,M11,5.6,18146,325373,307227
Georgia,2015,M05,6.1,295414,4812124,4516710
Kansas,2010,M05,6.8,101758,1495445,1393687
Pennsylvania,2001,M05,4.5,276146,6155810,5879664
New Hampshire,2015,M08,3.1,23312,751228,727916
Nebraska,2013,M01,4.5,45166,1010003,964837
North Dakota,2008,M02,3.7,13396,365529,352133
Utah,2014,M08,3.9,56404,1436176,1379772
Massachusetts,2014,M09,5.7,200910,3550277,3349367
Alabama,2006,M01,4.4,93680,2142558,2048878
Maine,2012,M10,6.5,46206,706463,660257
Kansas,2005,M08,5.0,73162,1459224,1386062
Louisiana,2010,M04,7.1,147906,2086875,1938969
Iowa,2010,M10,5.3,88485,1680139,1591654
South Dakota,2009,M12,5.3,23021,438455,415434
Puerto Rico,2009,M04,15.0,197212,1313192,1115980
Missouri,2002,M06,5.8,175529,3041587,2866058
New Jersey,2010,M08,9.3,426591,4583768,4157177
Minnesota,2011,M05,6.3,186718,2949506,2762788
Montana,2007,M05,2.9,14643,501190,486547
Wisconsin,2011,M06,8.2,256460,3121897,2865437
West Virginia,2005,M10,4.4,35223,800194,764971
Oklahoma,2003,M10,5.3,88977,1688571,1599594
Nebraska,2010,M02,5.3,52214,985427,933213
Arizona,2003,M11,5.2,142563,2767152,2624589
New Mexico,2013,M05,6.5,60185,919658,859473
Delaware,2012,M03,7.3,32715,446031,413316
District of Columbia,2004,M09,8.3,26003,313868,287865
North Dakota,2004,M09,2.7,9630,353224,343594
Massachusetts,2006,M04,4.9,164772,3373836,3209064
North Carolina,2012,M10,8.8,415617,4738036,4322419
North Carolina,2007,M12,4.9,219046,4510327,4291281
Vermont,2000,M02,3.2,10490,328152,317662
Mississippi,2015,M10,6.0,76935,1279614,1202679
Arkansas,2010,M12,8.2,111181,1351635,1240454
Nevada,2010,M07,13.7,186753,1364866,1178113
Louisiana,2007,M10,3.8,77329,2052521,1975192
Idaho,2016,M05,3.4,27316,812838,785522
North Dakota,2006,M07,3.0,11251,369020,357769
Maryland,2009,M01,6.5,195667,3007672,2812005
South Dakota,2013,M09,3.3,14820,443176,428356
Alabama,2002,M05,5.2,109369,2088168,1978799
Virginia,2005,M10,3.2,126694,3928156,3801462
Florida,2015,M10,5.2,498168,9636089,9137921
California,2007,M09,5.3,958487,17962357,17003870
Missouri,2005,M06,5.5,168115,3049439,2881324
West Virginia,2011,M02,9.6,77336,804698,727362
Oklahoma,2013,M02,5.6,100091,1796392,1696301
South Dakota,2005,M12,3.5,15121,428280,413159
Utah,2007,M05,2.3,31569,1352379,1320810
Puerto Rico,2012,M07,15.1,182333,1205079,1022746
Texas,2000,M04,4.0,415653,10365015,9949362
Colorado,2004,M04,5.4,135439,2503535,2368096
Wyoming,2013,M08,4.0,12450,308650,296200
Texas,2011,M05,7.6,948802,12466822,11518020
Kentucky,2008,M04,5.4,109702,2019535,1909833
Connecticut,2015,M05,5.6,106100,1895437,1789337
North Carolina,2000,M04,3.0,124042,4126291,4002249
Delaware,2002,M09,3.7,15366,410453,395087
Louisiana,2012,M05,7.2,149403,2083907,1934504
Arkansas,2016,M10,3.5,46406,1342421,1296015
Missouri,2002,M09,4.9,146317,2998033,2851716
New Jersey,2003,M01,6.4,275900,4325392,4049492
Rhode Island,2000,M06,4.0,21812,547526,525714
New York,2009,M03,8.2,790037,9632225,8842188
Utah,2009,M09,7.3,98541,1358491,1259950
New Mexico,2000,M02,5.2,43741,837368,793627
Hawaii,2010,M05,6.7,43268,644452,601184
Maryland,2011,M09,7.2,223830,3102413,2878583
South Dakota,2011,M03,5.8,25307,439187,413880
Kentucky,2008,M05,5.9,119402,2032918,1913516
Massachusetts,2006,M12,4.6,157090,3432858,3275768
Indiana,2006,M07,5.4,176071,3271069,3094998
West Virginia,2001,M12,4.8,38526,798547,760021
Oklahoma,2007,M12,3.6,61539,1721861,1660322
Maine,2006,M08,4.0,28812,719122,690310
Missouri,2001,M08,4.7,141152,2972373,2831221
Pennsylvania,2012,M03,7.9,503058,6406725,5903667
Florida,2013,M09,7.1,679385,9529753,8850368
North Carolina,2003,M07,6.8,292664,4285883,3993219
West Virginia,2014,M10,5.8,45991,788898,742907
Oklahoma,2008,M10,4.0,71530,1771069,1699539
Michigan,2006,M12,6.7,337484,5069957,4732473
Kansas,2013,M03,5.6,83111,1480039,1396928
Puerto Rico,2016,M12,12.0,136773,1138998,1002225
Kansas,2008,M02,4.4,64523,1480793,1416270
Alabama,2008,M11,6.7,145764,2175944,2030180
Virginia,2014,M06,5.4,231922,4287456,4055534
Arizona,2000,M06,4.3,107543,2515532,2407989
Kentucky,2004,M06,5.7,114423,1992017,1877594
New Mexico,2009,M04,7.2,67987,939719,871732
Utah,2005,M03,4.5,56157,1249038,1192881
Rhode Island,2013,M07,9.4,52783,563920,511137
Maine,2013,M07,6.2,44898,726196,681298
North Dakota,2008,M10,2.5,9068,369904,360836
District of Columbia,2004,M12,7.7,24363,315345,290982
Connecticut,2011,M06,9.0,174621,1934120,1759499
Arkansas,2000,M09,3.8,47620,1251025,1203405
South Dakota,2002,M08,2.9,12127,423897,411770
Florida,2002,M12,5.2,426632,8127589,7700957
Idaho,2004,M12,4.7,33673,713227,679554
Arizona,2008,M01,4.7,143570,3061807,2918237
Virginia,2009,M07,6.8,284983,4177294,3892311
Colorado,2008,M10,5.0,138222,2741759,2603537
West Virginia,2003,M02,7.3,57328,786921,729593
Oklahoma,2005,M02,5.0,84527,1679840,1595313
New Hampshire,2007,M05,3.4,24970,733475,708505
Iowa,2006,M09,3.4,56669,1662751,1606082
Maine,2012,M05,7.6,52886,698339,645453
Colorado,2002,M04,5.4,131661,2418823,2287162
Colorado,2000,M08,2.8,65254,2371561,2306307
West Virginia,2016,M09,5.4,42749,787174,744425
Tennessee,2010,M07,9.3,288182,3111613,2823431
Tennessee,2006,M10,4.4,135394,3081251,2945857
Virginia,2001,M03,2.8,104948,3683466,3578518
Florida,2007,M03,3.3,299029,9129235,8830206
North Carolina,2002,M04,6.8,283978,4191875,3907897
Texas,2015,M07,4.8,630680,13082442,12451762
Arizona,2002,M01,6.1,159950,2625895,2465945
Arizona,2003,M06,6.3,173220,2751194,2577974
Tennessee,2005,M09,4.8,138573,2904362,2765789
Kansas,2004,M08,5.5,81260,1465645,1384385
Delaware,2003,M01,4.7,19255,411654,392399
Puerto Rico,2014,M09,15.1,168769,1118336,949567
Virginia,2010,M05,7.1,296704,4185654,3888950
Nevada,2014,M11,7.3,101810,1402954,1301144
Oregon,2009,M05,11.6,230012,1976337,1746325
Indiana,2003,M09,5.0,158069,3170246,3012177
Minnesota,2016,M09,3.6,108951,3001492,2892541
Utah,2008,M03,3.4,46011,1363666,1317655
Nebraska,2000,M11,2.6,24514,945735,921221
Alabama,2007,M07,4.4,94996,2182352,2087356
Rhode Island,2016,M07,5.6,31448,560384,528936
Pennsylvania,2009,M12,8.1,508640,6292311,5783671
Arizona,2009,M02,8.6,269450,3120236,2850786
North Dakota,2004,M12,3.6,12459,349730,337271
South Carolina,2003,M06,7.6,155600,2035529,1879929
Michigan,2011,M07,11.8,560613,4746430,4185817
Kansas,2015,M07,4.7,70658,1507213,1436555
Iowa,2010,M11,5.4,91117,1678333,1587216
Wyoming,2001,M12,3.9,10512,267370,256858
Vermont,2011,M07,5.3,19158,362333,343175
Indiana,2004,M11,5.3,169947,3177372,3007425
California,2007,M08,5.4,971032,17929174,16958142
Nebraska,2006,M05,3.0,28740,971280,942540
Maine,2001,M02,4.3,28502,663695,635193
Kansas,2010,M04,6.9,102782,1498170,1395388
Kentucky,2003,M11,5.6,111197,1970379,1859182
New Mexico,2011,M04,7.0,64712,925244,860532
Pennsylvania,2008,M01,5.4,341412,6379282,6037870
District of Columbia,2010,M10,9.4,32363,345639,313276
Wyoming,2007,M07,2.7,7813,292045,284232
Missouri,2009,M02,9.5,287021,3036005,2748984
Vermont,2003,M03,5.0,17288,343758,326470
New Hampshire,2016,M09,2.6,19415,746963,727548
Illinois,2006,M02,5.4,344955,6417300,6072345
Nevada,2002,M12,5.3,60128,1133782,1073654
Arizona,2007,M03,3.6,108628,3022680,2914052
Washington,2011,M08,9.0,311660,3465034,3153374
Florida,2006,M04,2.8,250741,8887099,8636358
Utah,2001,M03,4.4,50818,1155281,1104463
New Mexico,2001,M08,4.7,40648,856679,816031
Iowa,2009,M05,6.2,105285,1688363,1583078
South Carolina,2000,M06,4.1,83583,2039873,1956290
South Carolina,2015,M01,6.9,154201,2241559,2087358
Vermont,2008,M05,4.2,14790,351213,336423
Oregon,2008,M11,8.2,161364,1979453,1818089
Massachusetts,2009,M05,7.7,265663,3449285,3183622
Kansas,2000,M01,3.7,52594,1413511,1360917
Georgia,2008,M09,6.7,323986,4806274,4482288
Pennsylvania,2001,M07,4.9,307155,6271279,5964124
Louisiana,2008,M05,4.3,88866,2070960,1982094
Michigan,2014,M04,7.0,327362,4693423,4366061
Nebraska,2003,M02,4.2,40474,956347,915873
Hawaii,2015,M09,3.6,24176,673139,648963
Florida,2005,M12,3.0,265692,8810015,8544323
Arizona,2002,M07,6.5,175775,2684160,2508385
District of Columbia,2016,M09,6.2,24088,390933,366845
Wisconsin,2009,M11,8.3,254794,3070326,2815532
Nevada,2008,M01,5.6,75722,1350690,1274968
Pennsylvania,2004,M04,5.1,311951,6149684,5837733
Utah,2004,M07,5.2,64349,1243494,1179145
Connecticut,2012,M11,7.8,145875,1870709,1724834
Kentucky,2004,M05,5.5,107607,1965153,1857546
Delaware,2006,M01,4.4,19517,438792,419275
Kansas,2006,M01,4.9,71887,1454397,1382510
Nebraska,2008,M08,3.2,31946,992635,960689
Arkansas,2010,M08,8.1,109690,1362392,1252702
Nevada,2003,M04,5.2,58960,1138115,1079155
Texas,2002,M01,6.4,677168,10583867,9906699
Arizona,2011,M02,9.5,287934,3035196,2747262
North Dakota,2011,M11,3.0,11562,388560,376998
Louisiana,2001,M03,5.5,111220,2036316,1925096
New Mexico,2016,M01,6.8,62184,921162,858978
Kentucky,2003,M06,6.8,136397,1999944,1863547
Michigan,2013,M12,7.6,354817,4689153,4334336
Arizona,2016,M03,5.3,171025,3223314,3052289
Texas,2000,M05,4.3,438808,10322564,9883756
South Dakota,2014,M10,2.8,12777,449500,436723
Montana,2008,M04,4.7,24035,507460,483425
Washington,2013,M02,8.1,278823,3457404,3178581
Alabama,2004,M03,5.9,126006,2125942,1999936
New Hampshire,2002,M07,4.3,30996,715861,684865
Puerto Rico,2006,M05,11.3,162254,1432289,1270035
Minnesota,2010,M07,7.3,215627,2972965,2757338
Hawaii,2002,M02,4.6,28010,603123,575113
Rhode Island,2011,M10,10.8,60294,560111,499817
Florida,2009,M12,11.1,996083,8977512,7981429
Idaho,2008,M06,5.0,38212,769797,731585
Massachusetts,2016,M07,3.9,139969,3634702,3494733
Oregon,2014,M07,7.0,137768,1967313,1829545
Pennsylvania,2014,M12,4.8,307475,6363345,6055870
Montana,2008,M05,4.3,22048,509766,487718
California,2009,M01,10.2,1868614,18241235,16372621
Nebraska,2009,M01,4.7,46032,983157,937125
Maine,2005,M12,4.5,31314,696751,665437
Washington,2002,M05,7.3,222650,3066758,2844108
Utah,2010,M02,8.3,112208,1347242,1235034
Pennsylvania,2012,M02,8.2,521333,6389602,5868269
Tennessee,2013,M07,8.1,252933,3109210,2856277
Michigan,2007,M10,6.7,332559,4987563,4655004
Alaska,2003,M01,8.7,28506,326427,297921
New Jersey,2016,M04,5.1,228488,4522552,4294064
Texas,2003,M02,6.8,735308,10852871,10117563
North Dakota,2008,M11,2.9,10771,365930,355159
Utah,2007,M04,2.2,30120,1342036,1311916
South Dakota,2016,M09,2.5,11406,451351,439945
Georgia,2016,M01,5.5,265324,4834499,4569175
Colorado,2007,M11,3.8,102022,2695350,2593328
Delaware,2011,M05,7.1,31433,440724,409291
Michigan,2012,M08,9.5,443982,4696493,4252511
Louisiana,2005,M12,6.7,133451,2004690,1871239
North Carolina,2008,M11,7.9,362969,4614816,4251847
Illinois,2009,M07,10.9,734276,6759906,6025630
Texas,2011,M04,7.4,924948,12442954,11518006
Kansas,2016,M05,3.9,57046,1475236,1418190
Wisconsin,2005,M09,4.1,124254,3022219,2897965
Arkansas,2004,M04,5.5,71606,1290720,1219114
Iowa,2012,M10,4.5,74715,1659158,1584443
Georgia,2009,M03,9.4,450643,4779732,4329089
Washington,2007,M07,4.6,156811,3435971,3279160
California,2003,M02,7.1,1225139,17283857,16058718
Wisconsin,2008,M03,5.2,158395,3067047,2908652
Nevada,2009,M11,12.1,162942,1343754,1180812
New Hampshire,2013,M12,4.6,33615,738716,705101
Utah,2000,M05,3.2,35759,1135012,1099253
Massachusetts,2001,M12,4.2,143919,3397734,3253815
Pennsylvania,2002,M12,5.6,346077,6178514,5832437
Alaska,2009,M09,7.2,26042,360500,334458
Maine,2009,M12,8.1,55819,689802,633983
Alabama,2015,M10,5.9,126424,2158879,2032455
Mississippi,2013,M08,8.3,104070,1257634,1153564
California,2003,M12,6.2,1077323,17272484,16195161
South Carolina,2007,M12,5.8,121614,2114475,1992861
Colorado,2006,M08,4.2,110204,2648988,2538784
Missouri,2006,M10,4.5,137366,3054778,2917412
Nebraska,2005,M04,3.7,36505,973550,937045
Connecticut,2012,M07,8.9,170923,1921016,1750093
Connecticut,2000,M10,1.7,29034,1756923,1727889
Wyoming,2010,M03,7.6,22842,300782,277940
South Carolina,2007,M05,5.1,109037,2125693,2016656
Nebraska,2002,M05,3.5,33648,956969,923321
Louisiana,2000,M09,5.5,110035,2017643,1907608
New Hampshire,2006,M01,3.9,28163,724195,696032
Louisiana,2011,M07,8.2,172725,2102070,1929345
Mississippi,2004,M09,6.2,81215,1308329,1227114
South Carolina,2015,M10,5.6,128545,2277063,2148518
Nebraska,2000,M12,2.6,24395,941012,916617
Kentucky,2008,M11,6.8,138525,2034907,1896382
Alaska,2010,M08,6.8,24853,367761,342908
Mississippi,2005,M05,6.7,89235,1325417,1236182
Connecticut,2003,M09,5.2,91743,1771005,1679262
North Carolina,2003,M09,6.0,253125,4232445,3979320
Maryland,2000,M06,3.9,109263,2829557,2720294
Colorado,2014,M03,6.1,169516,2796519,2627003
Michigan,2007,M11,6.5,322844,4989432,4666588
Delaware,2014,M02,6.5,28856,444032,415176
California,2004,M11,5.9,1025909,17486763,16460854
Rhode Island,2014,M10,6.5,35795,554201,518406
Utah,2000,M04,2.9,33103,1127999,1094896
Idaho,2002,M03,6.7,45688,679907,634219
Kentucky,2012,M09,7.8,160195,2062221,1902026
Missouri,2013,M06,7.1,217602,3071793,2854191
North Carolina,2012,M11,8.7,410004,4705950,4295946
North Carolina,2011,M11,9.6,447183,4649485,4202302
Louisiana,2012,M11,5.9,123151,2085566,1962415
Maryland,2005,M08,4.0,119172,2953276,2834104
Florida,2014,M07,6.7,644689,9643636,8998947
Georgia,2000,M03,3.8,158596,4223475,4064879
Pennsylvania,2006,M11,4.2,263033,6325197,6062164
New Hampshire,2001,M02,3.3,22563,693033,670470
Puerto Rico,2008,M10,12.9,172478,1332242,1159764
Massachusetts,2005,M02,5.4,181642,3355624,3173982
Arkansas,2009,M05,7.9,108025,1366414,1258389
Iowa,2013,M05,4.4,74237,1670910,1596673
Oregon,2003,M09,7.4,136094,1842525,1706431
Colorado,2008,M02,4.6,123037,2689551,2566514
Texas,2001,M02,4.1,430972,10449068,10018096
Alaska,2013,M11,6.9,25174,362911,337737
Alaska,2003,M03,8.7,28389,327789,299400
Vermont,2004,M05,3.4,11653,344924,333271
Hawaii,2016,M12,2.6,17691,691469,673778
Nebraska,2008,M09,3.2,31500,983280,951780
South Dakota,2015,M03,3.8,16836,448462,431626
New Jersey,2013,M09,7.8,349806,4488890,4139084
Alaska,2001,M11,6.5,20931,319660,298729
Illinois,2002,M11,6.3,396294,6283576,5887282
Kentucky,2000,M02,5.1,100547,1960500,1859953
Nevada,2002,M09,5.2,58974,1133181,1074207
New York,2010,M08,8.4,811144,9678098,8866954
South Carolina,2006,M07,6.6,140914,2132278,1991364
Colorado,2010,M01,8.9,240159,2699042,2458883
Rhode Island,2008,M06,7.3,41747,573069,531322
Nebraska,2012,M12,3.9,39142,1015292,976150
South Dakota,2013,M08,3.5,15766,449402,433636
Idaho,2016,M11,3.7,30103,818262,788159
Connecticut,2003,M11,5.1,90639,1782488,1691849
Idaho,2012,M02,8.6,65948,764311,698363
Colorado,2004,M09,5.0,127596,2552550,2424954
South Carolina,2010,M12,10.8,231105,2140626,1909521
West Virginia,2013,M03,7.4,58587,791508,732921
Mississippi,2004,M11,6.2,82302,1317095,1234793
Oklahoma,2011,M03,5.8,101468,1759397,1657929
North Dakota,2006,M06,3.5,13072,369944,356872
Colorado,2003,M08,5.8,145868,2506689,2360821
Oregon,2006,M04,5.4,101367,1865799,1764432
Alabama,2010,M10,9.9,219224,2220707,2001483
Pennsylvania,2005,M11,4.7,291281,6262319,5971038
District of Columbia,2005,M05,6.5,20228,313363,293135
Colorado,2010,M12,8.8,240169,2719777,2479608
New Hampshire,2008,M03,4.2,30905,740475,709570
Florida,2013,M11,6.6,619322,9431755,8812433
Missouri,2005,M07,5.4,165935,3045131,2879196
Illinois,2003,M11,6.3,397612,6308536,5910924
Kentucky,2015,M12,5.2,103425,1975251,1871826
Illinois,2010,M01,12.2,802173,6586885,5784712
Texas,2012,M05,6.7,844076,12650518,11806442
New York,2002,M06,6.0,557064,9332410,8775346
Virginia,2016,M05,3.7,158991,4240815,4081824
Wyoming,2014,M12,3.8,11613,303753,292140
Washington,2001,M12,7.3,221613,3044467,2822854
Connecticut,2000,M05,2.4,41792,1763638,1721846
South Carolina,2014,M09,6.8,153146,2241043,2087897
Louisiana,2004,M01,6.6,132879,2001041,1868162
New Jersey,2000,M02,4.3,183852,4291215,4107363
Maryland,2004,M11,4.1,118707,2899391,2780684
Illinois,2011,M08,10.3,682272,6646196,5963924
Maryland,2011,M11,6.8,209229,3098306,2889077
Nebraska,2006,M07,3.4,33102,986324,953222
South Carolina,2011,M03,10.3,221237,2152730,1931493
Minnesota,2008,M04,5.0,144996,2906723,2761727
Delaware,2000,M02,4.1,16775,404556,387781
Maine,2001,M08,3.3,22516,690335,667819
Hawaii,2008,M11,5.6,35547,635914,600367
Puerto Rico,2010,M05,17.1,217890,1270994,1053104
Nevada,2008,M03,5.6,76373,1356089,1279716
Hawaii,2009,M05,7.2,45639,631859,586220
Oregon,2003,M07,8.3,155680,1866659,1710979
Idaho,2012,M11,6.8,51869,768334,716465
Florida,2003,M03,5.0,410636,8155192,7744556
Tennessee,2010,M11,9.3,289161,3110858,2821697
Illinois,2013,M02,9.9,647815,6543208,5895393
Indiana,2001,M10,4.5,141562,3150247,3008685
Michigan,2001,M01,5.3,274891,5149667,4874776
Arizona,2014,M01,7.2,218357,3050414,2832057
Washington,2006,M05,5.0,164979,3305898,3140919
South Dakota,2016,M11,2.7,12215,454040,441825
Utah,2001,M07,4.6,54481,1174451,1119970
Indiana,2009,M01,9.7,311593,3211150,2899557
Delaware,2007,M01,3.9,16995,441121,424126
Alabama,2012,M04,7.2,156241,2163833,2007592
Florida,2009,M11,10.9,988736,9041671,8052935
Florida,2014,M11,5.8,558404,9591244,9032840
Virginia,2014,M08,5.6,235919,4247310,4011391
Arizona,2007,M01,4.1,122898,3023595,2900697
District of Columbia,2014,M03,7.8,28964,371277,342313
Mississippi,2006,M07,7.2,93627,1304614,1210987
New Hampshire,2005,M03,4.1,29198,719929,690731
Delaware,2015,M05,4.6,21399,464203,442804
New Hampshire,2000,M10,2.3,15746,687994,672248
Maine,2010,M10,7.3,50673,698667,647994
Louisiana,2007,M02,4.0,80070,1985241,1905171
Maine,2009,M01,8.4,58035,690525,632490
Minnesota,2002,M12,4.3,121865,2846546,2724681
Colorado,2009,M05,7.0,191469,2720052,2528583
Washington,2008,M09,5.1,178117,3487702,3309585
Rhode Island,2009,M07,11.4,65371,573895,508524
Ohio,2013,M04,6.9,391974,5675507,5283533
Michigan,2013,M11,7.7,362458,4713985,4351527
Arkansas,2011,M04,8.1,110239,1364644,1254405
Delaware,2001,M01,4.6,19322,421937,402615
Alabama,2016,M06,6.3,137606,2177701,2040095
Missouri,2014,M11,5.0,154259,3070829,2916570
Texas,2001,M11,5.7,602489,10603968,10001479
Texas,2014,M11,4.5,590599,13029358,12438759
Utah,2004,M05,5.0,61185,1223904,1162719
West Virginia,2008,M01,5.1,40734,806503,765769
Vermont,2011,M11,5.0,17897,356499,338602
Indiana,2004,M07,5.5,175674,3210693,3035019
Kentucky,2004,M07,5.6,110382,1980643,1870261
Oklahoma,2014,M01,5.3,94766,1781498,1686732
Louisiana,2005,M01,6.3,128284,2024262,1895978
Connecticut,2011,M07,9.1,177170,1945527,1768357
West Virginia,2003,M08,6.0,47080,786922,739842
Maine,2011,M05,8.0,55774,694071,638297
Oklahoma,2005,M08,4.4,75974,1710730,1634756
Massachusetts,2006,M05,4.7,160410,3383446,3223036
West Virginia,2016,M08,5.9,46854,787513,740659
Pennsylvania,2009,M09,7.9,501782,6348251,5846469
North Dakota,2005,M03,4.2,14626,350680,336054
New York,2013,M09,7.5,717560,9630327,8912767
Utah,2013,M03,5.0,69714,1392344,1322630
Washington,2004,M03,7.2,228140,3184839,2956699
District of Columbia,2008,M10,7.1,23462,330226,306764
Wisconsin,2015,M05,4.6,140618,3089419,2948801
Alaska,2005,M10,6.4,22181,344495,322314
Kentucky,2007,M08,5.0,101396,2018467,1917071
Connecticut,2016,M04,5.3,99967,1881896,1781929
Wyoming,2008,M04,3.0,8714,289203,280489
Oregon,2014,M05,6.6,126047,1923241,1797194
California,2016,M12,5.0,957110,19098452,18141342
Florida,2007,M05,3.5,318110,9144896,8826786
Rhode Island,2015,M09,5.2,28737,552332,523595
Washington,2002,M07,7.1,220745,3111553,2890808
North Carolina,2000,M12,3.9,161462,4161346,3999884
California,2016,M03,5.8,1104679,19085020,17980341
New Jersey,2006,M05,4.8,211601,4427256,4215655
Massachusetts,2010,M08,7.9,277055,3520010,3242955
West Virginia,2010,M10,8.0,65397,813557,748160
Oklahoma,2012,M10,5.2,95071,1824719,1729648
California,2008,M07,7.6,1397333,18306130,16908797
New York,2001,M10,5.4,490378,9160348,8669970
Alabama,2014,M04,6.2,134424,2153646,2019222
Virginia,2009,M03,6.6,270341,4121181,3850840
Pennsylvania,2000,M04,3.6,217768,6060813,5843045
South Dakota,2005,M05,3.9,16796,431106,414310
Utah,2016,M11,2.7,40660,1526692,1486032
Kansas,2002,M01,5.5,77270,1393086,1315816
Connecticut,2002,M01,3.9,68170,1740935,1672765
Alaska,2010,M02,9.1,32632,357061,324429
Pennsylvania,2013,M10,6.8,433128,6379140,5946012
Nebraska,2005,M05,3.7,36201,976026,939825
District of Columbia,2011,M01,9.9,34596,348377,313781
West Virginia,2005,M01,5.8,44741,773205,728464
Montana,2008,M11,5.7,28866,506177,477311
Oklahoma,2003,M01,5.7,95481,1673648,1578167
Kansas,2007,M09,4.2,61908,1483693,1421785
Louisiana,2007,M08,4.4,88981,2035611,1946630
Kansas,2000,M11,3.6,49902,1397705,1347803
Pennsylvania,2016,M05,5.3,343548,6484977,6141429
Massachusetts,2000,M04,2.4,81006,3310438,3229432
Wyoming,2016,M08,4.7,14322,304511,290189
New Hampshire,2009,M04,6.5,48059,741249,693190
Indiana,2016,M01,5.0,164921,3291001,3126080
Puerto Rico,2008,M04,10.1,134755,1340644,1205889
Minnesota,2003,M01,5.5,157831,2846779,2688948
Idaho,2009,M08,8.8,67480,763176,695696
Washington,2009,M03,8.5,299096,3513817,3214721
New Mexico,2014,M04,6.3,57807,914927,857120
District of Columbia,2009,M05,8.8,29240,330466,301226
Texas,2004,M01,6.6,720484,10943874,10223390
Puerto Rico,2016,M04,11.3,127927,1127448,999521
Indiana,2010,M10,9.3,295824,3165404,2869580
Iowa,2013,M04,4.8,79293,1669267,1589974
California,2004,M12,5.7,988415,17437874,16449459
District of Columbia,2015,M11,6.5,25271,389524,364253
North Carolina,2012,M12,9.0,421319,4683039,4261720
Minnesota,2007,M01,5.4,154518,2886876,2732358
Pennsylvania,2012,M05,7.7,496827,6473414,5976587
Connecticut,2012,M05,8.3,156870,1896030,1739160
Missouri,2010,M05,9.1,277942,3064076,2786134
Louisiana,2011,M05,7.7,159854,2071329,1911475
New York,2009,M01,7.8,748821,9648067,8899246
Texas,2002,M10,6.1,666012,10837643,10171631
Mississippi,2014,M04,6.8,83461,1232680,1149219
North Dakota,2003,M08,3.4,12082,352820,340738
New York,2016,M01,5.3,509899,9575623,9065724
Vermont,2011,M03,6.2,22333,358638,336305
Vermont,2011,M02,6.2,22219,358318,336099
Idaho,2001,M01,5.9,39136,661159,622023
Puerto Rico,2001,M09,12.6,160944,1276159,1115215
Georgia,2015,M12,5.4,259434,4829221,4569787
Arkansas,2010,M06,8.1,111410,1377267,1265857
Nebraska,2002,M04,3.6,34244,954016,919772
Kentucky,2007,M05,5.2,105338,2036520,1931182
Alaska,2005,M05,6.7,23124,344709,321585
Utah,2010,M08,8.0,108901,1364982,1256081
New Mexico,2011,M09,7.6,70424,930612,860188
Arizona,2011,M11,8.6,260006,3031526,2771520
Vermont,2010,M01,7.0,24991,357412,332421
Washington,2000,M03,5.5,169206,3081359,2912153
Colorado,2012,M07,7.8,217440,2772673,2555233
Alaska,2006,M06,6.5,23356,358237,334881
North Carolina,2002,M07,6.8,286393,4219512,3933119
Montana,2015,M07,3.8,20159,530399,510240
Maine,2016,M07,3.7,26109,710901,684792
Missouri,2016,M05,4.2,130546,3119644,2989098
Georgia,2013,M03,8.2,387534,4751840,4364306
Wisconsin,2012,M03,7.9,240295,3057206,2816911
Georgia,2010,M02,10.9,509056,4687285,4178229
Colorado,2016,M09,2.9,84799,2911124,2826325
Hawaii,2005,M01,3.1,19127,617256,598129
Virginia,2005,M12,3.1,120671,3909434,3788763
Alaska,2008,M02,7.6,26634,350568,323934
Tennessee,2006,M05,5.1,154904,3016967,2862063
District of Columbia,2012,M07,9.0,33553,372307,338754
Massachusetts,2002,M04,5.0,171607,3402709,3231102
Iowa,2016,M08,3.7,62720,1702436,1639716
Maine,2007,M08,4.0,28757,714029,685272
New Hampshire,2011,M04,5.2,38276,729877,691601
Indiana,2000,M02,3.8,118873,3124618,3005745
Virginia,2008,M02,3.6,148331,4067528,3919197
South Dakota,2013,M12,3.6,16053,442658,426605
Arkansas,2009,M06,8.1,112164,1381140,1268976
North Carolina,2016,M04,4.7,228678,4855395,4626717
Washington,2010,M01,11.3,396296,3516790,3120494
South Carolina,2013,M12,6.2,134045,2167469,2033424
Alabama,2002,M12,5.7,121340,2123087,2001747
Illinois,2008,M09,6.2,406940,6597259,6190319
Maryland,2013,M10,6.5,203263,3125483,2922220
Puerto Rico,2014,M07,13.9,156586,1122741,966155
Illinois,2000,M06,4.5,298709,6581373,6282664
Minnesota,2002,M09,4.0,114298,2861851,2747553
New York,2008,M01,5.5,525439,9577889,9052450
Vermont,2002,M10,3.4,11787,344270,332483
Tennessee,2011,M07,9.1,286936,3143315,2856379
Connecticut,2016,M06,5.4,103749,1913076,1809327
New Mexico,2013,M03,6.7,61201,917958,856757
Minnesota,2015,M03,4.5,132346,2963094,2830748
Idaho,2014,M01,6.2,47917,769598,721681
Georgia,2004,M03,4.4,195969,4418616,4222647
Texas,2005,M09,5.3,589810,11183158,10593348
Wisconsin,2007,M03,5.6,172323,3070414,2898091
Nebraska,2003,M08,3.8,36455,965774,929319
Arkansas,2008,M12,6.6,90645,1363556,1272911
Vermont,2007,M10,3.4,11901,351656,339755
Tennessee,2007,M08,4.6,141444,3056048,2914604
Idaho,2015,M08,4.0,32134,803513,771379
Hawaii,2000,M09,4.3,25872,601023,575151
Alaska,2014,M07,6.4,23982,377041,353059
Mississippi,2008,M04,5.1,66712,1305998,1239286
Wyoming,2001,M08,3.3,9063,272935,263872
New York,2012,M01,9.2,879821,9515496,8635675
Delaware,2015,M04,4.8,22223,463750,441527
Wisconsin,2011,M05,7.7,235811,3069458,2833647
Nevada,2014,M02,8.6,119348,1389152,1269804
Idaho,2003,M12,5.5,38165,689813,651648
Iowa,2003,M01,5.2,83705,1612433,1528728
Minnesota,2008,M05,4.9,142033,2917967,2775934
Massachusetts,2014,M12,4.9,175681,3560949,3385268
Idaho,2004,M01,6.6,45349,687753,642404
New Jersey,2015,M01,7.0,316476,4514331,4197855
Alabama,2006,M07,4.6,101217,2181686,2080469
Puerto Rico,2010,M10,16.0,203599,1270190,1066591
Washington,2011,M02,10.4,359310,3461174,3101864
West Virginia,2009,M07,8.0,66296,825970,759674
Oklahoma,2015,M07,4.5,83210,1843585,1760375
North Carolina,2001,M07,5.6,235200,4232932,3997732
Vermont,2007,M01,4.6,16412,354687,338275
New Hampshire,2014,M04,4.4,32475,735204,702729
New Jersey,2004,M08,4.5,197297,4371897,4174600
Georgia,2011,M02,10.4,486320,4693781,4207461
Tennessee,2007,M02,4.9,149075,3051936,2902861
Washington,2006,M04,4.8,158013,3292834,3134821
New York,2007,M07,4.9,472753,9668483,9195730
Rhode Island,2001,M08,4.8,26159,549226,523067
Vermont,2008,M08,4.3,15448,358348,342900
West Virginia,2009,M03,7.7,61776,806702,744926
Virginia,2013,M11,5.3,221681,4218878,3997197
Oklahoma,2015,M03,4.1,75597,1825189,1749592
Nebraska,2001,M05,2.9,27919,954136,926217
Idaho,2008,M09,5.1,38747,757657,718910
Maine,2002,M08,3.6,25245,693452,668207
Puerto Rico,2001,M11,11.1,143623,1296135,1152512
Missouri,2013,M08,6.9,209836,3022789,2812953
Montana,2004,M12,4.6,21816,477663,455847
California,2000,M08,5.0,854563,16954865,16100302
New Jersey,2005,M01,4.7,203276,4310347,4107071
Mississippi,2006,M05,6.3,80332,1284876,1204544
North Dakota,2016,M10,2.2,9260,417255,407995
Louisiana,2008,M04,3.6,74672,2059853,1985181
Michigan,2014,M05,7.5,359772,4778075,4418303
South Dakota,2010,M08,4.7,20774,446258,425484
Puerto Rico,2007,M08,12.2,167728,1369952,1202224
Alaska,2004,M02,8.9,29448,330635,301187
Tennessee,2013,M06,8.6,267566,3125769,2858203
Wisconsin,2016,M03,4.7,146817,3103663,2956846
Hawaii,2014,M03,4.5,29638,662803,633165
Arkansas,2008,M07,5.6,78731,1396457,1317726
Illinois,2005,M01,6.4,401612,6306673,5905061
Rhode Island,2002,M01,5.9,31905,544020,512115
Washington,2001,M05,5.9,177690,3026815,2849125
Kentucky,2001,M10,5.2,102213,1947670,1845457
South Carolina,2007,M03,5.3,111834,2111180,1999346
Nebraska,2002,M03,3.9,37140,949483,912343
Indiana,2006,M05,5.1,165673,3243356,3077683
Iowa,2014,M04,4.1,69094,1697476,1628382
Hawaii,2014,M07,4.4,29695,671715,642020
South Dakota,2004,M04,3.5,14672,424937,410265
Wyoming,2002,M03,4.6,12291,267172,254881
Vermont,2006,M12,3.5,12630,356219,343589
New York,2010,M06,8.4,809639,9675506,8865867
South Dakota,2012,M10,3.7,16634,444020,427386
Massachusetts,2006,M07,5.0,173389,3464997,3291608
Massachusetts,2001,M09,4.0,133507,3371911,3238404
Iowa,2003,M11,4.1,65810,1602354,1536544
Missouri,2014,M05,6.1,186797,3062472,2875675
Louisiana,2006,M08,4.5,88878,1997065,1908187
Washington,2001,M04,5.9,178550,3028879,2850329
Mississippi,2004,M08,6.2,80933,1307770,1226837
Tennessee,2001,M11,5.5,157206,2881603,2724397
Virginia,2010,M01,7.9,322815,4083205,3760390
Pennsylvania,2016,M04,5.2,334738,6459383,6124645
Arizona,2003,M01,6.1,165923,2700934,2535011
Alaska,2013,M03,7.5,26963,360341,333378
District of Columbia,2010,M03,9.5,32620,342516,309896
Maryland,2007,M05,3.3,97432,2955307,2857875
Montana,2008,M10,5.1,26147,508205,482058
New York,2016,M10,4.8,455099,9548033,9092934
Puerto Rico,2013,M06,13.8,160478,1160269,999791
Missouri,2014,M04,5.7,173377,3040534,2867157
Arkansas,2001,M10,4.5,55779,1251870,1196091
Alabama,2000,M02,5.1,109464,2136690,2027226
District of Columbia,2007,M09,5.7,18291,321973,303682
Kentucky,2012,M12,7.9,163325,2067803,1904478
Michigan,2005,M07,7.4,380217,5153926,4773709
Puerto Rico,2006,M12,9.7,137497,1412567,1275070
South Carolina,2012,M03,9.3,202027,2172100,1970073
Florida,2009,M05,10.1,924241,9134284,8210043
Texas,2014,M04,4.8,619308,12975129,12355821
Montana,2007,M10,3.6,17984,504027,486043
Georgia,2013,M07,8.8,422726,4797816,4375090
Tennessee,2014,M06,7.0,216043,3074741,2858698
Wyoming,2009,M12,7.5,22395,300582,278187
Iowa,2002,M11,3.7,61032,1630129,1569097
Mississippi,2008,M08,6.7,86724,1295056,1208332
Arkansas,2009,M12,8.1,108093,1335959,1227866
Arizona,2005,M01,4.9,138629,2822007,2683378
Tennessee,2010,M05,9.3,288555,3088063,2799508
South Dakota,2005,M07,3.6,15924,440541,424617
Mississippi,2011,M09,9.9,132354,1342640,1210286
Georgia,2003,M02,4.9,214956,4372253,4157297
Arkansas,2000,M08,4.1,51549,1260453,1208904
South Dakota,2002,M09,2.6,10947,416250,405303
New Hampshire,2016,M06,2.9,21559,754888,733329
New Hampshire,2003,M07,4.3,30866,722455,691589
New Hampshire,2007,M02,4.3,31221,733655,702434
Kentucky,2016,M02,5.9,116114,1970941,1854827
California,2000,M09,4.6,780879,16888364,16107485
Rhode Island,2011,M08,11.0,61850,563565,501715
New Mexico,2007,M10,3.5,32465,939823,907358
Alabama,2012,M09,7.6,165201,2172512,2007311
North Dakota,2001,M03,3.6,12099,340450,328351
Kentucky,2006,M02,6.8,136460,2005432,1868972
New Mexico,2015,M04,6.1,56406,921215,864809
California,2004,M08,5.9,1036235,17436940,16400705
Arkansas,2016,M11,3.4,45836,1334504,1288668
New Mexico,2001,M02,5.1,43656,852848,809192
Missouri,2005,M12,4.6,138998,2992538,2853540
Delaware,2008,M04,4.0,17962,447238,429276
Ohio,2008,M05,5.9,353803,5976492,5622689
Kansas,2002,M10,4.9,69483,1423035,1353552
Pennsylvania,2013,M01,8.8,570081,6468116,5898035
Texas,2009,M12,8.0,952707,11965823,11013116
Minnesota,2007,M11,4.0,117642,2907026,2789384
New Jersey,2002,M09,5.5,237828,4328767,4090939
West Virginia,2014,M06,6.6,52522,800539,748017
Arkansas,2007,M12,5.2,70213,1363190,1292977
Oklahoma,2008,M06,4.0,70949,1766580,1695631
Utah,2000,M12,3.2,36683,1154797,1118114
Pennsylvania,2002,M05,5.5,342509,6221095,5878586
Alabama,2014,M11,5.8,124177,2157875,2033698
Minnesota,2011,M11,5.3,154749,2938772,2784023
Ohio,2012,M10,6.8,389148,5736775,5347627
New Jersey,2015,M07,6.2,286734,4591500,4304766
New Mexico,2007,M01,4.0,37184,923964,886780
Wisconsin,2001,M11,4.6,139243,3004030,2864787
New Jersey,2011,M10,9.0,411455,4569948,4158493
Rhode Island,2003,M06,5.2,29573,565621,536048
Virginia,2013,M03,5.7,239948,4219621,3979673
Mississippi,2005,M03,6.5,85351,1314219,1228868
District of Columbia,2007,M07,5.7,18810,328277,309467
Georgia,2008,M12,8.1,389049,4787974,4398925
Maine,2014,M12,5.1,34720,684626,649906
North Carolina,2002,M03,7.0,292070,4189215,3897145
Alabama,2003,M02,6.0,127265,2107471,1980206
District of Columbia,2015,M01,7.8,29805,383676,353871
Florida,2014,M09,6.2,602230,9641768,9039538
Illinois,2016,M08,5.8,380780,6542874,6162094
West Virginia,2016,M06,6.1,48771,795837,747066
Kentucky,2012,M07,8.6,177483,2072880,1895397
Michigan,2005,M12,6.4,325958,5076002,4750044
Connecticut,2013,M07,8.1,153920,1907910,1753990
Montana,2016,M12,4.3,22261,522823,500562
West Virginia,2001,M06,5.0,41200,821527,780327
Virginia,2007,M08,3.1,125244,4039095,3913851
Kentucky,2005,M04,5.6,111497,1989921,1878424
Oklahoma,2007,M06,4.6,80024,1750583,1670559
Louisiana,2010,M07,8.4,179468,2129241,1949773
Georgia,2001,M02,3.7,156390,4266787,4110397
Illinois,2011,M02,9.9,646023,6520184,5874161
Massachusetts,2009,M07,8.4,296530,3534280,3237750
Missouri,2016,M04,4.3,133954,3117499,2983545
Connecticut,2001,M08,3.4,60055,1773960,1713905
Texas,2011,M06,8.4,1054438,12545539,11491101
South Carolina,2008,M01,6.0,126942,2111622,1984680
Florida,2001,M12,5.8,469155,8049559,7580404
Georgia,2003,M11,4.3,187948,4414889,4226941
Massachusetts,2009,M03,7.8,267350,3443396,3176046
Virginia,2002,M02,4.5,166011,3703149,3537138
Virginia,2002,M03,4.4,161425,3710251,3548826
New Jersey,2002,M06,5.9,257716,4382981,4125265
Colorado,2001,M10,4.3,105209,2423499,2318290
California,2001,M03,5.3,907688,17163257,16255569
Missouri,2016,M06,4.9,155158,3152760,2997602
Iowa,2005,M09,3.8,62364,1632250,1569886
Maryland,2004,M10,4.0,115725,2897727,2782002
Oregon,2003,M04,8.6,158956,1846861,1687905
Hawaii,2003,M08,4.2,25322,603646,578324
Indiana,2008,M10,6.2,200017,3248725,3048708
Alabama,2005,M12,3.9,83794,2163518,2079724
Vermont,2015,M03,4.0,13851,345174,331323
North Dakota,2000,M11,2.6,8678,339221,330543
Idaho,2004,M06,4.5,31921,710086,678165
New Jersey,2001,M05,3.7,157313,4255074,4097761
Hawaii,2015,M12,2.8,19180,679784,660604
Connecticut,2001,M02,3.3,57486,1746161,1688675
Delaware,2007,M10,3.4,14991,444029,429038
Georgia,2012,M10,8.8,421341,4805143,4383802
Michigan,2009,M12,13.5,650755,4817301,4166546
California,2010,M07,12.6,2316525,18432464,16115939
Kentucky,2010,M02,11.9,242983,2046735,1803752
Wyoming,2006,M11,3.0,8434,282990,274556
California,2015,M01,7.2,1359407,18842970,17483563
New Mexico,2006,M12,3.4,32123,935202,903079
Tennessee,2002,M09,4.5,129877,2911410,2781533
New Hampshire,2009,M09,6.1,45099,738481,693382
New Hampshire,2007,M10,3.0,21825,734587,712762
Texas,2000,M07,4.5,469465,10386886,9917421
Montana,2002,M02,5.3,24435,461201,436766
Missouri,2006,M03,5.0,150316,2998662,2848346
North Dakota,2000,M01,4.0,13490,335785,322295
Georgia,2006,M06,5.1,238282,4709770,4471488
Wyoming,2016,M06,5.6,17119,308256,291137
Washington,2012,M03,8.9,308147,3479429,3171282
Kentucky,2004,M12,4.8,95055,1969432,1874377
District of Columbia,2002,M04,5.8,17606,305474,287868
New York,2011,M01,9.0,849694,9482821,8633127
Pennsylvania,2007,M07,4.7,302387,6451428,6149041
Maryland,2015,M03,5.4,167571,3125309,2957738
Arizona,2014,M10,6.5,204531,3135574,2931043
Kansas,2009,M02,6.3,95734,1510718,1414984
Nevada,2001,M11,5.9,66540,1121813,1055273
Minnesota,2013,M10,4.1,121065,2952226,2831161
Indiana,2012,M09,7.7,244251,3162100,2917849
Illinois,2013,M08,9.1,598269,6573797,5975528
Wisconsin,2002,M04,5.7,172568,3002082,2829514
New Hampshire,2012,M08,5.4,40754,751218,710464
Massachusetts,2009,M12,8.5,294287,3451717,3157430
Pennsylvania,2010,M12,7.7,487125,6351726,5864601
Massachusetts,2016,M05,3.7,131194,3569607,3438413
New Jersey,2013,M11,6.9,309187,4468593,4159406
Virginia,2012,M09,5.8,244312,4221249,3976937
Puerto Rico,2001,M12,9.7,125051,1286105,1161054
Idaho,2011,M06,7.9,61392,772349,710957
Minnesota,2000,M08,2.9,83178,2835391,2752213
Vermont,2000,M03,3.1,10081,328962,318881
Oregon,2015,M01,6.4,123093,1930824,1807731
New York,2007,M05,4.2,395958,9444962,9049004
Kentucky,2000,M11,4.1,80082,1970759,1890677
Arkansas,2016,M06,4.2,57869,1361968,1304099
California,2011,M05,11.3,2071724,18332712,16260988
Georgia,2005,M06,5.7,259493,4584727,4325234
Mississippi,2009,M08,9.4,118496,1254973,1136477
Mississippi,2010,M10,9.7,130843,1342193,1211350
Vermont,2004,M01,4.8,16704,345699,328995
Ohio,2013,M07,7.8,450560,5800430,5349870
Delaware,2011,M03,7.9,34796,441425,406629
North Carolina,2004,M11,5.3,225313,4273101,4047788
North Carolina,2003,M11,6.1,260058,4272418,4012360
Montana,2012,M09,5.1,25714,507527,481813
New Mexico,2009,M03,7.3,68467,938368,869901
Utah,2005,M04,4.1,50829,1252645,1201816
Washington,2002,M06,7.3,226304,3092932,2866628
South Carolina,2013,M01,9.1,199113,2177835,1978722
Minnesota,2011,M03,7.4,216669,2931702,2715033
Michigan,2006,M03,7.4,373565,5066889,4693324
Kansas,2013,M12,4.4,65193,1483884,1418691
Kentucky,2008,M10,6.5,131081,2028523,1897442
South Dakota,2016,M01,3.3,14459,443642,429183
South Carolina,2012,M02,10.0,216670,2167648,1950978
Ohio,2012,M05,6.9,395787,5712297,5316510
Connecticut,2008,M06,5.6,106224,1898926,1792702
Tennessee,2001,M10,4.9,141612,2875775,2734163
Alaska,2009,M11,8.0,28621,357869,329248
Illinois,2010,M11,9.4,620510,6586993,5966483
West Virginia,2016,M05,5.8,45348,785503,740155
Hawaii,2005,M12,2.3,14729,633213,618484
Vermont,2014,M09,3.9,13535,346833,333298
Virginia,2001,M04,2.6,96707,3664380,3567673
Montana,2000,M02,6.0,27897,463315,435418
Nebraska,2004,M12,3.7,36121,967337,931216
Delaware,2007,M09,3.2,14197,439606,425409
West Virginia,2015,M11,5.7,44473,777074,732601
Oklahoma,2009,M11,6.6,117209,1768376,1651167
Alabama,2011,M04,9.4,207316,2204162,1996846
Washington,2001,M06,6.1,184914,3046431,2861517
Missouri,2007,M09,5.2,157331,3028467,2871136
Utah,2012,M09,4.8,65956,1377778,1311822
Wyoming,2008,M07,2.7,7982,298278,290296
Louisiana,2008,M11,5.3,110727,2107881,1997154
Maryland,2014,M09,5.5,172493,3125064,2952571
Washington,2011,M10,8.6,297041,3467602,3170561
Pennsylvania,2013,M11,6.4,406880,6385781,5978901
North Dakota,2010,M02,4.8,17616,369203,351587
Iowa,2011,M07,5.2,87885,1674849,1586964
Kentucky,2007,M12,5.3,106587,2024954,1918367
Wyoming,2015,M05,4.1,12520,305204,292684
Arkansas,2013,M04,7.0,92031,1311950,1219919
Texas,2011,M03,7.7,960466,12423980,11463514
Massachusetts,2005,M05,4.6,153736,3360814,3207078
Kansas,2012,M07,6.2,93792,1503383,1409591
Hawaii,2010,M03,6.9,44035,637716,593681
Vermont,2004,M07,3.4,12000,352998,340998
Maryland,2012,M11,6.6,207613,3125518,2917905
Pennsylvania,2011,M10,7.5,480256,6401406,5921150
South Carolina,2000,M05,3.6,73283,2011522,1938239
Missouri,2013,M05,6.6,200014,3042359,2842345
Iowa,2010,M04,5.9,98609,1679875,1581266
Wyoming,2006,M03,3.6,10092,277582,267490
Louisiana,2008,M06,5.4,113951,2115757,2001806
Kansas,2014,M03,4.9,73359,1492961,1419602
Alaska,2006,M07,5.8,20982,360904,339922
North Carolina,2002,M06,6.9,289180,4207451,3918271
Arkansas,2005,M09,4.9,65966,1357162,1291196
Alaska,2004,M08,6.2,21394,342748,321354
Delaware,2012,M12,6.8,30416,444477,414061
Alaska,2015,M04,6.6,23522,358214,334692
Minnesota,2012,M04,5.4,159146,2925916,2766770
Kansas,2015,M04,4.2,62270,1484279,1422009
Nevada,2006,M04,4.1,52466,1271574,1219108
Iowa,2010,M05,5.6,94095,1676186,1582091
New Jersey,2005,M05,4.0,175553,4364596,4189043
Mississippi,2006,M01,8.0,102028,1280047,1178019
New Hampshire,2006,M11,3.4,24783,733095,708312
Florida,2001,M11,5.9,476113,8029874,7553761
Florida,2006,M11,3.3,303974,9122141,8818167
Alaska,2009,M06,7.9,29041,367342,338301
Massachusetts,2010,M10,7.5,258385,3462509,3204124
New Hampshire,2014,M06,4.2,31578,748672,717094
Virginia,2006,M08,3.3,130586,4004958,3874372
Nebraska,2016,M07,3.5,35980,1026937,990957
District of Columbia,2003,M02,7.0,21258,304132,282874
Massachusetts,2013,M08,6.6,233647,3552032,3318385
Connecticut,2002,M12,4.7,84346,1777067,1692721
Montana,2005,M04,4.5,21702,482678,460976
Tennessee,2009,M05,10.6,324434,3064147,2739713
Rhode Island,2015,M01,7.5,41679,552107,510428
Pennsylvania,2002,M07,5.7,361314,6310328,5949014
Delaware,2008,M05,4.0,17700,445812,428112
Wisconsin,2010,M09,7.5,231509,3072257,2840748
Maryland,2015,M11,4.7,146750,3151406,3004656
Arizona,2013,M07,8.3,253152,3046628,2793476
Washington,2016,M01,6.2,222835,3580828,3357993
Michigan,2005,M11,6.3,319334,5088795,4769461
Illinois,2000,M07,4.5,296245,6546831,6250586
District of Columbia,2005,M06,6.8,21661,319172,297511
New Mexico,2008,M02,3.9,36695,935816,899121
Kentucky,2007,M04,5.1,104290,2028339,1924049
Minnesota,2005,M07,3.6,105050,2905712,2800662
South Carolina,2004,M12,6.8,138995,2034427,1895432
Ohio,2011,M11,7.6,435448,5738960,5303512
Arkansas,2015,M04,5.1,67557,1326832,1259275
Indiana,2010,M08,10.1,323906,3195374,2871468
Nevada,2013,M07,9.7,135144,1390907,1255763
Kansas,2003,M08,5.7,82349,1434323,1351974
New Hampshire,2013,M06,5.0,37138,748746,711608
District of Columbia,2001,M12,6.2,19026,305287,286261
Louisiana,2003,M09,6.3,125315,2002817,1877502
Pennsylvania,2001,M04,4.2,257094,6128293,5871199
South Dakota,2014,M01,4.2,18314,439569,421255
Delaware,2013,M07,6.8,30351,446223,415872
Connecticut,2004,M09,4.6,80344,1763370,1683026
Kentucky,2015,M09,4.8,93766,1952044,1858278
Tennessee,2005,M04,5.5,158334,2869491,2711157
Puerto Rico,2009,M05,14.6,191934,1310650,1118716
Connecticut,2013,M01,8.6,159994,1853316,1693322
Tennessee,2001,M02,4.2,118606,2842791,2724185
District of Columbia,2010,M06,9.5,33596,352782,319186
Michigan,2006,M11,6.4,324066,5063506,4739440
West Virginia,2002,M06,6.2,50514,811771,761257
Oklahoma,2004,M06,5.4,92574,1713801,1621227
Oregon,2000,M09,4.4,80780,1815784,1735004
Maryland,2016,M12,3.9,122921,3172633,3049712
North Dakota,2013,M08,2.6,10862,414557,403695
Nebraska,2015,M09,2.9,28547,1001011,972464
Montana,2014,M07,4.2,22235,525637,503402
Arizona,2007,M09,4.0,120639,3050452,2929813
Alaska,2006,M11,6.4,22148,347374,325226
Mississippi,2001,M03,5.4,70642,1307812,1237170
Illinois,2001,M11,5.7,362420,6409656,6047236
Kentucky,2011,M08,9.1,187106,2047102,1859996
Oregon,2006,M12,5.0,94426,1904960,1810534
North Carolina,2006,M03,4.6,200454,4363750,4163296
Missouri,2005,M04,5.3,160188,3008946,2848758
Montana,2000,M11,4.7,21955,462787,440832
Vermont,2005,M10,2.9,10349,353585,343236
New Mexico,2006,M08,4.4,40925,930940,890015
Texas,2009,M04,6.1,724529,11784180,11059651
Hawaii,2016,M06,3.6,24984,686621,661637
Rhode Island,2011,M06,10.5,59167,562353,503186
Arkansas,2010,M04,7.8,105687,1350258,1244571
Georgia,2005,M09,5.7,262277,4629904,4367627
Nebraska,2002,M06,4.0,38231,967379,929148
Washington,2010,M11,9.8,339836,3485054,3145218
Minnesota,2010,M04,7.5,218797,2934149,2715352
New Mexico,2012,M07,7.7,72032,931480,859448
Utah,2016,M12,2.9,44456,1527220,1482764
West Virginia,2005,M06,5.3,42300,800787,758487
Kentucky,2009,M04,10.0,205367,2061356,1855989
Oklahoma,2003,M06,6.2,106024,1714071,1608047
Delaware,2014,M12,4.6,21001,459540,438539
Ohio,2005,M01,6.8,395614,5791280,5395666
North Carolina,2001,M04,4.8,201602,4194668,3993066
West Virginia,2009,M04,7.8,63645,818093,754448
Oklahoma,2015,M04,4.0,72993,1829287,1756294
Indiana,2005,M05,5.2,166228,3205204,3038976
North Carolina,2004,M12,5.2,222758,4253048,4030290
Ohio,2007,M05,5.2,312948,5980985,5668037
Massachusetts,2013,M03,7.0,242331,3484192,3241861
Puerto Rico,2012,M04,14.5,172403,1185581,1013178
South Carolina,2009,M09,11.5,245694,2140835,1895141
Louisiana,2014,M10,6.8,149338,2198644,2049306
Connecticut,2012,M01,8.7,163347,1885452,1722105
South Carolina,2004,M05,6.4,130967,2033909,1902942
West Virginia,2016,M01,7.2,55903,774279,718376
District of Columbia,2000,M01,5.9,18074,305775,287701
New Mexico,2014,M06,7.5,69377,926291,856914
Wyoming,2010,M04,7.0,20935,301054,280119
Texas,2003,M06,7.6,833565,11014976,10181411
Michigan,2010,M10,11.1,525886,4740309,4214423
Oregon,2007,M04,5.1,98044,1905776,1807732
New York,2009,M05,8.0,772957,9635537,8862580
Nebraska,2005,M07,3.9,39019,989071,950052
Louisiana,2016,M05,5.9,124825,2126138,2001313
Georgia,2007,M12,5.0,246364,4894080,4647716
Virginia,2012,M07,6.4,274236,4258840,3984604
Mississippi,2016,M05,5.9,75602,1279090,1203488
Oregon,2000,M07,5.1,93018,1837073,1744055
Wyoming,2006,M08,2.8,8043,284801,276758
Colorado,2003,M10,5.6,139909,2510642,2370733
Missouri,2003,M08,5.9,178789,3012408,2833619
Missouri,2001,M02,5.1,153857,3014535,2860678
Georgia,2002,M06,5.4,234357,4330836,4096479
South Carolina,2015,M11,5.3,120874,2265518,2144644
Alabama,2001,M03,4.7,99910,2121522,2021612
Ohio,2004,M02,6.7,388927,5813451,5424524
Arizona,2016,M05,5.1,163739,3220802,3057063
Minnesota,2000,M01,3.9,108326,2769289,2660963
Texas,2011,M08,8.0,1007986,12528639,11520653
New Mexico,2013,M06,7.7,71408,928769,857361
Alaska,2002,M06,7.4,24711,332826,308115
Ohio,2016,M11,4.5,256301,5692448,5436147
New Mexico,2016,M06,7.5,70024,932354,862330
Illinois,2007,M07,5.3,359740,6776634,6416894
Kentucky,2003,M01,6.7,128680,1931843,1803163
District of Columbia,2009,M12,9.8,33218,339294,306076
Oregon,2014,M01,7.8,148456,1896525,1748069
Wyoming,2003,M02,5.1,13673,269258,255585
Texas,2007,M08,4.3,491278,11396050,10904772
Minnesota,2012,M10,4.9,144069,2961298,2817229
Florida,2008,M02,4.8,441018,9115842,8674824
Maine,2012,M08,6.5,46665,717916,671251
New Jersey,2006,M01,5.2,226772,4393778,4167006
Georgia,2001,M06,4.1,175539,4252465,4076926
Alabama,2010,M12,9.8,217272,2213810,1996538
Colorado,2000,M05,2.5,59072,2337241,2278169
North Dakota,2005,M02,4.2,14664,349694,335030
Alaska,2013,M05,6.9,25133,365543,340410
Ohio,2004,M11,6.1,359565,5900554,5540989
Michigan,2003,M04,7.0,349823,4981222,4631399
District of Columbia,2010,M05,8.9,30902,346604,315702
Idaho,2003,M06,5.2,36702,699240,662538
Georgia,2013,M04,7.8,372141,4749306,4377165
Alaska,2012,M09,6.3,22912,365772,342860
Mississippi,2008,M02,5.9,78004,1311059,1233055
Alabama,2015,M06,6.7,145355,2170213,2024858
Michigan,2002,M03,7.1,358131,5035940,4677809
North Carolina,2009,M10,10.6,482205,4551720,4069515
New York,2014,M09,5.8,550240,9513236,8962996
Virginia,2009,M12,7.2,293388,4059359,3765971
Oregon,2016,M03,5.2,106457,2034388,1927931
Alabama,2013,M11,6.7,144052,2164366,2020314
Montana,2006,M11,3.0,14694,490263,475569
Maryland,2016,M01,4.8,149803,3134982,2985179
Massachusetts,2001,M01,3.7,122822,3343291,3220469
Georgia,2016,M06,5.6,273846,4914807,4640961
Oregon,2016,M07,5.3,110678,2084202,1973524
Wisconsin,2012,M05,6.9,212368,3068660,2856292
Minnesota,2011,M08,6.2,184189,2965383,2781194
Connecticut,2005,M11,4.5,80726,1808875,1728149
Missouri,2003,M02,5.8,174641,3001631,2826990
Connecticut,2002,M11,4.9,87000,1784858,1697858
New Mexico,2001,M10,4.7,40357,862336,821979
Tennessee,2003,M08,5.7,165170,2901843,2736673
Minnesota,2004,M01,5.9,168084,2858551,2690467
Maryland,2010,M02,8.3,250159,3021144,2770985
Nevada,2003,M08,4.9,56857,1150760,1093903
District of Columbia,2007,M04,4.8,15298,318644,303346
Ohio,2006,M02,5.9,346449,5852463,5506014
Mississippi,2010,M11,9.8,132044,1345641,1213597
New Jersey,2012,M08,9.4,431355,4600392,4169037
Alabama,2012,M06,9.0,197672,2203489,2005817
Alaska,2016,M03,7.2,25741,357230,331489
New Jersey,2002,M07,6.1,267648,4394338,4126690
Puerto Rico,2009,M11,15.8,203535,1291505,1087970
New Jersey,2016,M09,4.9,220483,4500021,4279538
Ohio,2010,M10,9.3,539529,5831032,5291503
Michigan,2004,M09,6.5,327581,5049640,4722059
New Hampshire,2012,M03,5.8,42840,737975,695135
Nevada,2007,M09,4.6,62121,1336230,1274109
New Jersey,2013,M03,8.7,397029,4541864,4144835
Wyoming,2000,M02,4.7,12280,262109,249829
Tennessee,2011,M01,10.1,312770,3101841,2789071
Illinois,2006,M12,4.2,281371,6628481,6347110
Vermont,2012,M08,4.8,17058,358293,341235
Louisiana,2016,M06,6.9,149501,2155187,2005686
Tennessee,2008,M11,7.2,221100,3051214,2830114
New Jersey,2005,M06,4.3,188469,4427742,4239273
Mississippi,2014,M12,6.8,85085,1253715,1168630
Rhode Island,2004,M11,4.4,24735,561242,536507
Alabama,2000,M10,4.5,96899,2139361,2042462
Arkansas,2001,M02,5.3,66179,1244194,1178015
California,2012,M08,10.4,1933475,18555034,16621559
Missouri,2000,M01,3.5,103087,2920672,2817585
North Dakota,2007,M12,3.2,11602,363986,352384
Nevada,2016,M05,5.7,80669,1423834,1343165
South Dakota,2014,M08,3.1,14106,452651,438545
Louisiana,2005,M11,10.3,215876,2091097,1875221
Georgia,2015,M04,5.7,270836,4766129,4495293
Virginia,2003,M05,4.1,152770,3758664,3605894
Ohio,2011,M05,8.7,503046,5782168,5279122
Puerto Rico,2003,M08,12.2,162601,1330673,1168072
Mississippi,2014,M02,8.1,101008,1240688,1139680
Hawaii,2006,M12,1.9,12359,640724,628365
Iowa,2000,M01,3.4,53471,1581423,1527952
North Carolina,2013,M02,9.1,424318,4676226,4251908
Alaska,2011,M04,7.9,28389,360268,331879
Colorado,2004,M08,5.2,131855,2558993,2427138
Maine,2008,M01,5.7,39276,693861,654585
West Virginia,2013,M05,6.3,50074,800508,750434
Oklahoma,2011,M05,5.7,101082,1766178,1665096
Connecticut,2003,M06,5.7,103629,1806931,1703302
South Dakota,2000,M04,2.2,9074,407655,398581
Indiana,2000,M03,3.8,119887,3135960,3016073
Tennessee,2009,M11,9.9,298548,3028768,2730220
Louisiana,2000,M06,6.1,126292,2075100,1948808
Washington,2004,M04,6.3,198993,3172455,2973462
North Carolina,2010,M06,10.9,503871,4641162,4137291
Missouri,2012,M11,6.2,185633,3014588,2828955
Delaware,2006,M12,2.9,12981,443210,430229
Montana,2009,M04,7.0,34858,500933,466075
Florida,2012,M10,8.1,764746,9482296,8717550
Tennessee,2008,M02,5.8,176111,3024850,2848739
New Mexico,2004,M09,5.2,46912,900260,853348
Rhode Island,2011,M01,12.0,67294,560307,493013
Texas,2000,M11,3.9,406582,10416157,10009575
Nevada,2008,M12,9.0,122140,1361525,1239385
Illinois,2008,M08,6.7,446781,6668616,6221835
Indiana,2009,M08,10.3,327432,3185931,2858499
Indiana,2014,M07,6.1,198349,3261582,3063233
Oregon,2016,M11,4.3,89684,2070415,1980731
Massachusetts,2013,M02,7.2,250471,3482245,3231774
Alaska,2001,M06,6.5,21399,328540,307141
North Carolina,2005,M07,5.6,244247,4375455,4131208
South Dakota,2011,M07,4.3,19436,449329,429893
District of Columbia,2009,M06,9.6,32348,337843,305495
Mississippi,2005,M01,7.3,94947,1308815,1213868
Vermont,2015,M05,3.3,11450,344055,332605
Tennessee,2010,M01,11.2,340231,3038585,2698354
Texas,2010,M04,7.9,965539,12255014,11289475
New Jersey,2016,M08,5.0,229302,4545123,4315821
Missouri,2006,M05,4.3,130119,3016075,2885956
Missouri,2013,M11,5.8,174732,3005766,2831034
Mississippi,2004,M01,6.3,82074,1303277,1221203
Alaska,2013,M10,6.6,23826,363324,339498
District of Columbia,2006,M12,5.5,17506,317103,299597
Kansas,2007,M05,4.1,59919,1474078,1414159
Utah,2000,M06,3.7,42740,1150896,1108156
New York,2006,M03,5.0,469084,9471150,9002066
Virginia,2013,M08,5.8,246596,4247117,4000521
Washington,2013,M09,6.4,221450,3463960,3242510
Hawaii,2001,M11,5.6,34125,610660,576535
Utah,2010,M10,7.3,99605,1357414,1257809
Minnesota,2001,M09,3.5,98938,2843924,2744986
Virginia,2015,M01,5.2,218303,4211670,3993367
Rhode Island,2015,M08,5.9,33161,559144,525983
Texas,2006,M09,4.7,537698,11351283,10813585
Tennessee,2008,M07,7.0,216879,3099583,2882704
Hawaii,2002,M10,3.8,22621,594737,572116
District of Columbia,2014,M06,7.9,30098,379580,349482
Pennsylvania,2012,M09,7.4,481251,6479252,5998001
Ohio,2000,M07,4.3,250051,5848369,5598318
South Dakota,2006,M04,2.9,12631,429955,417324
Puerto Rico,2004,M11,9.9,133695,1346031,1212336
Florida,2013,M07,7.6,722705,9529916,8807211
Colorado,2010,M11,8.9,241314,2721998,2480684
West Virginia,2004,M08,5.1,40043,786148,746105
Iowa,2015,M04,3.6,60631,1700441,1639810
Georgia,2009,M05,9.5,454138,4781154,4327016
Oklahoma,2002,M08,4.4,74020,1682726,1608706
West Virginia,2010,M06,8.4,69109,818874,749765
Georgia,2000,M12,3.0,129048,4263305,4134257
Oklahoma,2012,M06,5.5,100506,1823693,1723187
Maine,2006,M12,4.4,30555,701553,670998
Florida,2016,M05,4.5,445147,9819355,9374208
Missouri,2001,M04,4.2,125303,3012669,2887366
Vermont,2012,M11,4.4,15694,352802,337108
Massachusetts,2003,M11,5.3,180527,3419331,3238804
Kansas,2003,M06,6.0,86929,1458667,1371738
Alabama,2001,M07,5.1,107206,2113078,2005872
Arkansas,2000,M03,4.5,56629,1263111,1206482
Hawaii,2008,M12,5.6,35513,632747,597234
Virginia,2009,M02,6.4,265313,4114098,3848785
Rhode Island,2010,M09,10.7,60774,566212,505438
Wyoming,2010,M02,7.8,23266,299182,275916
North Dakota,2009,M01,4.9,17901,364542,346641
Utah,2006,M12,2.1,28404,1338499,1310095
New York,2014,M07,6.5,625936,9675838,9049902
New York,2010,M10,8.2,780123,9547937,8767814
Illinois,2012,M08,9.2,607085,6604866,5997781
District of Columbia,2016,M06,6.3,24938,394651,369713
South Dakota,2012,M06,4.2,19017,450695,431678
Puerto Rico,2012,M02,15.2,183415,1209594,1026179
Wisconsin,2016,M04,4.1,127379,3098029,2970650
Nebraska,2010,M06,4.9,48868,1006269,957401
Mississippi,2010,M08,9.6,127494,1327294,1199800
Pennsylvania,2010,M01,9.5,599838,6327086,5727248
Wyoming,2001,M10,3.4,9049,269452,260403
Kansas,2002,M09,4.9,69821,1416719,1346898
Oregon,2013,M06,8.0,153988,1919637,1765649
Wyoming,2005,M07,3.3,9322,282065,272743
West Virginia,2013,M06,6.7,54511,811203,756692
Oklahoma,2011,M06,6.2,111143,1785736,1674593
Tennessee,2003,M11,5.6,164364,2911173,2746809
Alabama,2004,M05,5.4,114147,2123720,2009573
Connecticut,2005,M08,5.0,90102,1819725,1729623
Ohio,2008,M06,6.5,393931,6030063,5636132
Ohio,2003,M01,6.8,397442,5822750,5425308
Kentucky,2004,M01,6.3,122971,1944765,1821794
Louisiana,2006,M03,4.3,83509,1961439,1877930
Alabama,2013,M12,6.7,143618,2157137,2013519
Arizona,2009,M11,10.7,333907,3129969,2796062
Kansas,2000,M06,3.6,52118,1428214,1376096
Kansas,2010,M08,7.2,108161,1498201,1390040
West Virginia,2002,M07,5.8,46818,807271,760453
Oklahoma,2004,M07,4.7,79967,1705765,1625798
New Mexico,2012,M03,7.1,65876,923322,857446
Idaho,2014,M10,4.0,31351,784241,752890
South Dakota,2015,M06,3.0,13981,459497,445516
Ohio,2015,M02,5.6,318415,5656693,5338278
Oklahoma,2016,M10,4.8,88124,1833474,1745350
Pennsylvania,2016,M03,5.7,369891,6474709,6104818
South Dakota,2003,M04,3.4,14414,419848,405434
South Carolina,2005,M07,6.6,138812,2097378,1958566
Oregon,2006,M02,6.3,116075,1850639,1734564
Utah,2006,M07,3.2,42561,1332284,1289723
Texas,2007,M11,4.1,474029,11549764,11075735
Georgia,2010,M06,10.6,492775,4667938,4175163
Kansas,2004,M01,6.0,87414,1446348,1358934
Puerto Rico,2009,M12,14.5,185470,1281411,1095941
Delaware,2016,M10,4.2,19814,470204,450390
Wyoming,2007,M09,2.4,6957,287821,280864
Michigan,2016,M09,4.8,233070,4860874,4627804
New Jersey,2003,M12,5.0,216118,4347648,4131530
North Dakota,2004,M08,3.1,11343,360099,348756
Connecticut,2016,M10,4.2,79435,1885732,1806297
Massachusetts,2012,M10,6.2,218585,3500444,3281859
Hawaii,2013,M02,4.9,31800,643001,611201
New Hampshire,2000,M08,2.6,18299,697807,679508
Georgia,2012,M01,9.8,466557,4759634,4293077
New Mexico,2005,M06,5.9,54670,925291,870621
Indiana,2006,M12,4.6,149350,3234429,3085079
New Mexico,2002,M12,5.2,46136,884854,838718
West Virginia,2000,M03,6.0,48285,801305,753020
Oklahoma,2006,M03,4.0,68204,1703663,1635459
South Carolina,2011,M02,11.0,235186,2146141,1910955
New York,2010,M05,8.2,792560,9616724,8824164
Louisiana,2001,M12,5.9,117365,2002969,1885604
New Hampshire,2004,M07,3.6,26202,730791,704589
Ohio,2015,M07,5.0,286766,5749457,5462691
Nebraska,2011,M07,4.6,46405,1018395,971990
Alabama,2015,M09,5.9,127053,2144102,2017049
Oregon,2012,M07,9.0,176543,1971419,1794876
Connecticut,2014,M02,7.5,139729,1858617,1718888
Oregon,2009,M01,11.1,219219,1969348,1750129
Georgia,2009,M06,10.5,506610,4812293,4305683
Nebraska,2003,M03,4.2,40275,959565,919290
Tennessee,2000,M04,3.3,92744,2839074,2746330
Montana,2001,M02,5.5,25580,462999,437419
Alabama,2007,M06,4.2,92790,2184718,2091928
Georgia,2004,M08,5.0,223854,4460571,4236717
Illinois,2013,M09,8.6,565205,6544602,5979397
Arkansas,2010,M01,9.0,119140,1322432,1203292
Ohio,2002,M09,5.1,298689,5850859,5552170
Texas,2009,M01,6.4,749603,11718136,10968533
Hawaii,2013,M12,4.4,29016,658864,629848
Georgia,2002,M07,5.2,226065,4339389,4113324
Maine,2007,M09,4.2,29619,698698,669079
New Hampshire,2001,M05,2.9,20439,693816,673377
New Mexico,2016,M09,6.8,62481,925371,862890
Maine,2002,M05,4.2,27914,669001,641087
District of Columbia,2003,M04,6.2,18896,304087,285191
South Carolina,2016,M11,4.0,91905,2285900,2193995
Hawaii,2001,M08,4.1,25069,610016,584947
Indiana,2010,M12,9.2,290079,3136526,2846447
Colorado,2009,M03,7.1,192220,2711334,2519114
Nebraska,2005,M02,4.4,42336,967865,925529
Tennessee,2010,M06,9.5,294960,3109495,2814535
Arkansas,2008,M02,5.4,74056,1362151,1288095
Florida,2015,M01,5.9,564169,9557542,8993373
West Virginia,2006,M09,4.7,38095,812340,774245
Oklahoma,2000,M09,2.9,47682,1655309,1607627
North Dakota,2002,M07,3.5,12176,348767,336591
Illinois,2001,M07,5.2,337199,6523838,6186639
Iowa,2016,M03,4.0,67435,1698856,1631421
Vermont,2003,M02,5.0,17225,343909,326684
Arizona,2000,M02,3.9,97464,2502816,2405352
Oregon,2013,M05,7.6,144066,1896108,1752042
Puerto Rico,2014,M01,14.4,168897,1169964,1001067
Minnesota,2013,M04,5.1,150292,2944238,2793946
New Hampshire,2000,M03,3.0,20576,682183,661607
Alabama,2004,M06,6.1,131745,2144802,2013057
Louisiana,2009,M04,5.8,119192,2052957,1933765
Kentucky,2015,M07,5.7,112714,1973556,1860842
District of Columbia,2006,M11,5.7,18152,317734,299582
California,2004,M10,5.7,996727,17452451,16455724
New York,2013,M07,7.8,765455,9768137,9002682
Connecticut,2014,M07,6.8,131122,1918762,1787640
West Virginia,2010,M04,8.4,67894,811990,744096
Wyoming,2000,M11,4.0,10603,268300,257697
Alabama,2009,M08,11.9,257266,2166591,1909325
Louisiana,2013,M07,7.3,155985,2142526,1986541
Nebraska,2014,M03,4.0,40131,1015092,974961
Oklahoma,2012,M04,4.6,82699,1790035,1707336
Rhode Island,2016,M12,4.5,24653,550196,525543
Arkansas,2012,M11,7.0,91631,1317032,1225401
Maine,2010,M02,9.5,64821,685916,621095
North Carolina,2010,M05,10.9,506280,4663523,4157243
Texas,2012,M06,7.3,933622,12732361,11798739
New Mexico,2012,M04,6.6,60275,919514,859239
Virginia,2016,M06,4.2,178517,4258789,4080272
Idaho,2013,M09,5.4,41772,772293,730521
Oregon,2009,M12,10.8,211141,1951938,1740797
New Jersey,2011,M08,9.2,424019,4592987,4168968
Tennessee,2009,M01,9.8,297511,3037143,2739632
Vermont,2003,M11,3.9,13625,346550,332925
Kentucky,2004,M04,5.4,104955,1957734,1852779
Virginia,2000,M02,2.9,102244,3586234,3483990
Maine,2012,M01,8.7,60257,692536,632279
Maine,2005,M08,4.2,30380,717449,687069
Nevada,2016,M08,5.5,79024,1429173,1350149
Colorado,2014,M12,4.1,116212,2808591,2692379
Delaware,2002,M01,4.5,18897,419410,400513
West Virginia,2011,M10,7.2,58354,811912,753558
Oklahoma,2013,M10,5.4,96820,1804930,1708110
Iowa,2000,M11,2.6,41280,1597015,1555735
Connecticut,2010,M12,8.7,166091,1906439,1740348
New Hampshire,2010,M09,5.3,39163,733009,693846
Oregon,2008,M03,6.0,116066,1932419,1816353
Utah,2009,M01,6.6,90845,1374693,1283848
Massachusetts,2012,M09,6.6,229800,3479227,3249427
South Carolina,2000,M03,3.5,69941,1985416,1915475
Nebraska,2007,M03,2.9,27996,968221,940225
New Jersey,2000,M10,3.4,143785,4249737,4105952
South Carolina,2000,M07,3.9,78948,2016937,1937989
Illinois,2005,M12,5.1,329069,6432180,6103111
Alaska,2005,M06,6.8,23892,351139,327247
Idaho,2002,M02,6.9,46514,678937,632423
Virginia,2010,M08,7.1,298036,4184500,3886464
Massachusetts,2001,M08,3.8,129041,3414218,3285177
Georgia,2000,M02,3.7,157572,4204542,4046970
Minnesota,2007,M07,4.4,130089,2940035,2809946
Colorado,2015,M07,3.8,109764,2852645,2742881
Virginia,2015,M09,4.1,172971,4169891,3996920
Alaska,2006,M05,6.6,23194,350726,327532
North Dakota,2009,M05,3.9,14398,369768,355370
Florida,2016,M04,4.6,450261,9766559,9316298
Hawaii,2001,M04,4.3,26209,614139,587930
Montana,2013,M10,4.9,25032,512026,486994
District of Columbia,2010,M09,9.4,32301,344844,312543
North Dakota,2006,M09,2.5,8924,362308,353384
Iowa,2010,M02,7.1,119414,1673399,1553985
Colorado,2004,M06,5.7,144198,2550473,2406275
Florida,2000,M06,4.0,319304,7885467,7566163
Puerto Rico,2016,M03,12.2,137705,1126982,989277
District of Columbia,2007,M03,5.4,17246,320210,302964
Nebraska,2016,M05,3.0,29932,1013004,983072
Rhode Island,2014,M04,7.9,43324,551144,507820
Idaho,2016,M08,3.7,30223,821604,791381
Delaware,2007,M08,3.2,14436,445043,430607
New York,2014,M05,6.2,593382,9554121,8960739
North Carolina,2010,M08,10.5,486253,4623985,4137732
Maine,2003,M07,4.8,33536,701743,668207
Montana,2015,M09,3.4,17808,518656,500848
South Dakota,2015,M09,2.6,11498,448477,436979
Connecticut,2003,M04,5.3,93675,1774915,1681240
Pennsylvania,2005,M04,4.7,290199,6205141,5914942
Kansas,2010,M12,6.4,96108,1491469,1395361
California,2005,M09,5.1,897067,17598850,16701783
Alabama,2013,M08,7.5,162808,2167203,2004395
Illinois,2000,M05,4.1,266675,6475167,6208492
North Dakota,2010,M04,3.8,14424,375895,361471
Pennsylvania,2005,M02,5.8,361808,6192737,5830929
North Dakota,2016,M11,2.6,10765,413729,402964
Arizona,2009,M05,9.3,290147,3119101,2828954
Wisconsin,2010,M10,7.4,227500,3069318,2841818
Utah,2009,M07,7.7,105629,1374722,1269093
District of Columbia,2006,M06,6.2,19727,320714,300987
South Dakota,2011,M01,5.8,25228,433672,408444
Minnesota,2008,M11,5.7,166249,2937862,2771613
Colorado,2007,M06,3.8,102732,2681008,2578276
Florida,2007,M06,4.1,377574,9198162,8820588
North Carolina,2007,M07,5.1,231083,4567458,4336375
Rhode Island,2014,M02,9.4,52070,553707,501637
Vermont,2013,M09,4.3,14955,350362,335407
Nevada,2013,M05,9.6,132712,1383063,1250351
Hawaii,2004,M10,3.2,19842,610606,590764
Texas,2011,M10,7.5,938526,12594220,11655694
North Dakota,2012,M03,3.7,14665,391252,376587
Delaware,2004,M09,4.0,16814,416925,400111
Mississippi,2000,M07,5.7,76014,1331961,1255947
Michigan,2011,M09,10.0,467642,4693941,4226299
Pennsylvania,2011,M06,8.4,539325,6451913,5912588
Idaho,2000,M04,4.9,32049,654082,622033
Missouri,2004,M09,5.8,174348,2997519,2823171
Utah,2015,M09,3.3,48682,1470503,1421821
Ohio,2003,M10,5.5,320663,5860833,5540170
South Dakota,2013,M01,4.6,20040,436114,416074
Maryland,2009,M09,7.1,214697,3027247,2812550
California,2010,M02,12.6,2300364,18231451,15931087
North Dakota,2013,M01,3.8,15303,397753,382450
Ohio,2016,M01,5.6,317810,5649557,5331747
South Dakota,2008,M06,2.8,12927,454479,441552
Minnesota,2009,M10,7.1,209456,2931706,2722250
New Mexico,2002,M08,5.6,48805,877524,828719
Kansas,2011,M06,6.7,100531,1503900,1403369
District of Columbia,2014,M08,8.2,30983,379075,348092
North Dakota,2014,M11,2.4,9782,415082,405300
Alabama,2008,M02,4.9,106990,2167554,2060564
Florida,2003,M09,5.4,441712,8248601,7806889
Virginia,2014,M03,5.6,237894,4272849,4034955
Oregon,2009,M06,11.7,233779,1992692,1758913
Georgia,2009,M01,9.0,430867,4772066,4341199
Virginia,2002,M12,4.0,150003,3718649,3568646
Idaho,2013,M08,5.8,44794,776295,731501
Wisconsin,2008,M01,5.2,158305,3065592,2907287
Idaho,2000,M05,4.1,27017,658150,631133
Ohio,2012,M06,7.5,434855,5764601,5329746
South Carolina,2003,M05,6.5,129929,1999402,1869473
Connecticut,2008,M05,5.3,98694,1878878,1780184
North Carolina,2006,M05,4.7,208846,4433233,4224387
Pennsylvania,2012,M06,8.2,539369,6539130,5999761
Mississippi,2001,M05,4.9,63542,1294036,1230494
Connecticut,2012,M06,8.6,164489,1909407,1744918
Indiana,2000,M08,3.1,96190,3121849,3025659
Georgia,2015,M01,6.5,311995,4765230,4453235
Arkansas,2006,M09,4.9,67285,1361968,1294683
Louisiana,2011,M06,8.7,183107,2101522,1918415
Nevada,2015,M11,6.3,89016,1420319,1331303
Alaska,2001,M07,5.6,18707,332627,313920
North Carolina,2005,M06,5.5,240573,4336522,4095949
Delaware,2015,M12,4.1,19572,473091,453519
Ohio,2000,M06,4.2,246086,5843605,5597519
District of Columbia,2006,M01,5.9,18517,311599,293082
South Dakota,2011,M06,4.6,20444,448478,428034
Montana,2002,M12,4.6,21341,465215,443874
Kansas,2008,M06,4.6,69820,1516716,1446896
Rhode Island,2000,M03,4.4,23530,537989,514459
Idaho,2003,M04,6.1,42007,687356,645349
Vermont,2010,M08,5.6,20441,362070,341629
Maryland,2011,M10,7.0,218095,3107933,2889838
Alabama,2003,M07,6.3,134250,2119747,1985497
Colorado,2006,M01,5.1,130636,2576274,2445638
Missouri,2015,M08,4.9,150512,3081120,2930608
California,2006,M08,4.9,871011,17735844,16864833
Mississippi,2005,M12,7.9,103046,1303364,1200318
Missouri,2012,M10,6.3,190777,3037823,2847046
Virginia,2014,M12,4.6,193603,4195888,4002285
New Hampshire,2008,M08,3.7,27821,753537,725716
Kansas,2008,M04,3.8,56550,1485993,1429443
Washington,2006,M12,4.9,164601,3358417,3193816
Tennessee,2007,M09,4.8,148201,3063309,2915108
West Virginia,2013,M08,6.5,52157,800613,748456
Vermont,2012,M03,5.5,19369,354514,335145
Pennsylvania,2009,M03,8.2,522329,6401531,5879202
Oklahoma,2011,M08,5.9,103871,1772306,1668435
North Carolina,2005,M11,5.0,217301,4352477,4135176
Idaho,2011,M02,9.8,74226,758859,684633
New Jersey,2013,M08,8.0,363427,4546533,4183106
Washington,2010,M08,9.6,337371,3514797,3177426
South Carolina,2014,M04,5.3,115851,2195842,2079991
New York,2016,M08,4.9,474278,9627104,9152826
Montana,2004,M04,4.8,23050,479656,456606
Missouri,2005,M03,6.1,182635,2992136,2809501
Indiana,2001,M09,4.1,127032,3131517,3004485
Ohio,2012,M11,6.7,380262,5691843,5311581
Washington,2002,M02,8.2,250625,3064752,2814127
North Dakota,2013,M05,2.6,10658,408302,397644
Montana,2014,M12,4.4,22494,508602,486108
Maryland,2008,M03,3.4,102308,2967644,2865336
California,2013,M10,8.5,1589404,18600060,17010656
Oregon,2009,M11,10.3,202049,1961675,1759626
Hawaii,2011,M07,6.9,46126,666657,620531
Kentucky,2016,M12,4.5,90832,2009243,1918411
Delaware,2010,M07,8.4,37002,440646,403644
Texas,2010,M07,8.4,1037014,12298601,11261587
Maryland,2006,M01,3.9,115050,2918027,2802977
Delaware,2011,M02,8.3,36575,438488,401913
West Virginia,2013,M11,6.2,48890,791811,742921
Oklahoma,2011,M11,5.6,100299,1794205,1693906
California,2002,M06,6.7,1159420,17264407,16104987
Indiana,2016,M08,4.4,147078,3334171,3187093
Vermont,2005,M03,4.1,14177,347016,332839
Minnesota,2014,M02,5.4,159336,2950681,2791345
Texas,2000,M02,4.7,490214,10354582,9864368
Connecticut,2013,M11,6.8,127782,1865898,1738116
Minnesota,2003,M08,4.6,133782,2893938,2760156
Connecticut,2010,M11,9.0,171805,1918471,1746666
Nebraska,2009,M08,4.7,46543,994613,948070
Wyoming,2009,M03,6.3,18628,297893,279265
Colorado,2014,M08,4.6,129702,2827227,2697525
Pennsylvania,2011,M11,7.3,470095,6408926,5938831
Mississippi,2002,M11,6.3,80624,1285455,1204831
Maine,2015,M11,3.9,26473,676317,649844
Arizona,2004,M09,4.9,137822,2809200,2671378
Colorado,2000,M07,2.9,67813,2377886,2310073
Puerto Rico,2006,M02,9.9,140210,1411740,1271530
Kentucky,2013,M10,7.7,157130,2037721,1880591
Wyoming,2010,M08,5.6,16990,305471,288481
West Virginia,2002,M12,5.7,44881,787296,742415
Oklahoma,2004,M12,4.5,75972,1690280,1614308
South Carolina,2011,M04,10.0,217904,2168954,1951050
Minnesota,2008,M03,5.5,158646,2897845,2739199
Missouri,2009,M10,9.2,280258,3037295,2757037
Connecticut,2002,M10,4.6,81363,1786253,1704890
Massachusetts,2010,M01,9.6,332131,3460619,3128488
Nevada,2001,M05,4.6,50754,1106119,1055365
Oregon,2004,M01,8.7,159639,1827649,1668010
Nevada,2015,M08,6.7,95558,1417123,1321565
Rhode Island,2009,M02,11.3,63825,566873,503048
Georgia,2006,M09,4.6,219933,4733210,4513277
New Jersey,2008,M08,5.4,246726,4537836,4291110
Texas,2007,M03,4.1,464933,11362030,10897097
Tennessee,2002,M06,5.2,153800,2933009,2779209
District of Columbia,2004,M07,8.4,26841,319178,292337
Minnesota,2004,M12,4.2,120985,2867635,2746650
Nebraska,2001,M06,3.3,32202,964294,932092
Arkansas,2012,M04,7.1,95596,1350022,1254426
Illinois,2014,M12,5.8,374714,6444987,6070273
New Hampshire,2006,M07,3.3,25000,746389,721389
Idaho,2009,M02,8.8,65806,749516,683710
Delaware,2001,M12,3.3,13999,421744,407745
Nebraska,2016,M11,2.8,27976,1010228,982252
Connecticut,2014,M11,5.9,112065,1889932,1777867
Colorado,2015,M05,4.0,113241,2828860,2715619
Ohio,2015,M06,5.1,290847,5744170,5453323
North Dakota,2009,M11,3.6,13065,365064,351999
Florida,2003,M11,4.9,403315,8266747,7863432
New York,2014,M01,7.4,707156,9537710,8830554
Florida,2000,M11,3.5,278970,7898634,7619664
Illinois,2006,M11,3.9,258729,6605443,6346714
Hawaii,2001,M06,4.9,29935,615615,585680
Washington,2008,M08,5.4,188860,3497910,3309050
Missouri,2002,M01,5.9,173628,2967453,2793825
Texas,2004,M06,6.4,708911,11035215,10326304
New Hampshire,2014,M02,5.1,37887,739309,701422
Georgia,2011,M04,9.7,457159,4711178,4254019
Tennessee,2005,M06,5.9,172794,2926896,2754102
Texas,2014,M03,5.4,708292,13009711,12301419
Texas,2014,M02,5.7,733529,12963720,12230191
Missouri,2004,M11,5.7,172681,3014365,2841684
Hawaii,2007,M03,2.6,16600,641765,625165
Oregon,2012,M03,9.6,188981,1965031,1776050
Hawaii,2007,M02,2.4,15506,639656,624150
Delaware,2016,M09,4.3,20185,467885,447700
Nebraska,2011,M03,4.8,47666,996782,949116
Rhode Island,2000,M11,3.6,19573,546313,526740
Pennsylvania,2014,M02,6.8,432660,6358701,5926041
Louisiana,2004,M06,7.0,145833,2074577,1928744
Rhode Island,2002,M05,4.7,25732,543948,518216
New York,2000,M02,5.3,485168,9147182,8662014
Washington,2001,M01,6.3,192178,3042099,2849921
Maine,2005,M02,5.8,39806,681244,641438
Idaho,2007,M07,2.5,18822,767161,748339
Florida,2009,M02,9.5,861402,9095863,8234461
Connecticut,2007,M10,4.4,81770,1866132,1784362
New York,2015,M07,5.3,516141,9694219,9178078
Massachusetts,2015,M10,4.3,152072,3574008,3421936
Maryland,2008,M11,5.0,152068,3019491,2867423
Rhode Island,2007,M02,5.5,31217,571202,539985
Alaska,2011,M08,6.6,24386,372217,347831
Puerto Rico,2002,M02,13.7,183770,1343626,1159856
Tennessee,2014,M05,6.3,192492,3039412,2846920
Oregon,2002,M04,7.8,143351,1826376,1683025
South Dakota,2003,M05,3.3,14138,422974,408836
District of Columbia,2014,M12,7.3,28011,381573,353562
North Carolina,2010,M11,10.5,485936,4618475,4132539
Wisconsin,2007,M09,4.3,134223,3088638,2954415
Iowa,2016,M12,3.6,60330,1684529,1624199
District of Columbia,2003,M03,6.8,20570,304460,283890
Nevada,2016,M06,6.0,84989,1427966,1342977
Arkansas,2014,M10,5.2,67750,1312234,1244484
Illinois,2003,M05,6.4,401896,6264674,5862778
Arkansas,2010,M07,8.4,115397,1375717,1260320
Texas,2012,M11,6.1,772543,12743515,11970972
Alaska,2015,M09,5.8,21048,362931,341883
South Dakota,2006,M02,3.6,15273,426069,410796
Alaska,2000,M11,6.3,20033,316452,296419
Tennessee,2007,M12,5.4,163998,3060951,2896953
Colorado,2012,M06,8.3,229598,2776812,2547214
Hawaii,2006,M07,2.9,18419,644918,626499
Maine,2008,M09,5.1,35529,699442,663913
Louisiana,2014,M09,7.0,152332,2180289,2027957
Puerto Rico,2012,M11,13.5,159892,1185203,1025311
Nebraska,2002,M10,3.3,31043,954924,923881
Indiana,2014,M01,6.6,208416,3165074,2956658
Pennsylvania,2001,M01,5.0,305541,6133049,5827508
Connecticut,2001,M09,3.0,51809,1750712,1698903
North Carolina,2001,M09,5.6,234342,4184699,3950357
West Virginia,2009,M09,7.5,61549,815372,753823
Oklahoma,2015,M09,4.3,78365,1833100,1754735
Kentucky,2010,M09,9.6,196583,2051327,1854744
New Mexico,2008,M07,4.9,46627,953025,906398
Minnesota,2005,M02,5.0,142255,2849989,2707734
Michigan,2008,M12,9.2,447675,4859689,4412014
Vermont,2004,M11,3.3,11373,346779,335406
North Dakota,2008,M03,3.7,13418,367476,354058
District of Columbia,2008,M03,5.8,19018,327964,308946
Wyoming,2012,M06,5.2,16272,312119,295847
Mississippi,2009,M11,9.7,121823,1258194,1136371
Alaska,2001,M05,6.4,20706,322092,301386
Maine,2008,M11,6.2,43327,696006,652679
Iowa,2003,M04,4.5,72129,1609415,1537286
Georgia,2005,M10,5.3,246829,4637591,4390762
West Virginia,2013,M12,6.4,50394,786333,735939
Oregon,2013,M09,6.9,132978,1914458,1781480
Oklahoma,2011,M12,5.6,99369,1785591,1686222
Wisconsin,2004,M10,4.0,122215,3019953,2897738
Georgia,2015,M07,6.4,307241,4806583,4499342
Colorado,2015,M06,4.2,118941,2854512,2735571
Nebraska,2010,M09,4.2,41718,985886,944168
Idaho,2003,M05,5.2,35984,689423,653439
Illinois,2010,M08,10.1,673324,6654476,5981152
Nevada,2004,M09,4.1,48243,1184801,1136558
South Carolina,2005,M01,7.1,144825,2028533,1883708
New Hampshire,2013,M01,6.1,44936,741372,696436
Mississippi,2012,M03,8.5,112431,1318635,1206204
Indiana,2015,M02,5.6,181723,3226739,3045016
Tennessee,2011,M11,7.8,242961,3117853,2874892
Iowa,2007,M06,3.6,61065,1673837,1612772
North Carolina,2012,M02,9.9,458754,4639967,4181213
Alaska,2007,M10,5.8,20396,349686,329290
Kansas,2008,M05,4.3,63850,1490891,1427041
North Carolina,2011,M03,10.2,468811,4612453,4143642
Kansas,2015,M01,4.8,70678,1485361,1414683
Montana,2007,M04,3.2,15888,498188,482300
Colorado,2006,M09,3.9,101960,2642235,2540275
Wyoming,2015,M06,4.3,13393,311380,297987
Idaho,2000,M12,5.0,33028,663783,630755
Colorado,2003,M05,5.8,142214,2463284,2321070
Minnesota,2011,M10,5.4,159561,2948059,2788498
Oklahoma,2016,M11,4.6,84586,1837205,1752619
Florida,2007,M08,4.5,409870,9167032,8757162
Montana,2009,M12,7.4,36556,494813,458257
South Dakota,2000,M02,2.9,11827,403634,391807
Minnesota,2013,M05,4.7,138281,2956204,2817923
Virginia,2001,M08,3.6,131373,3657960,3526587
Hawaii,2015,M07,3.5,23478,678271,654793
Alaska,2016,M12,6.6,23311,355793,332482
Ohio,2004,M06,6.5,384808,5916786,5531978
Nevada,2010,M05,13.3,180306,1357873,1177567
South Carolina,2012,M09,8.6,187423,2180983,1993560
Georgia,2010,M04,9.9,460951,4663907,4202956
West Virginia,2010,M05,8.3,67383,813742,746359
Oklahoma,2012,M05,5.1,92047,1799806,1707759
New Jersey,2009,M07,9.7,447210,4633870,4186660
Connecticut,2004,M06,5.2,92739,1791961,1699222
Nevada,2009,M02,10.2,139209,1359289,1220080
Missouri,2015,M11,4.0,121913,3084351,2962438
Virginia,2011,M03,6.6,275304,4195456,3920152
Louisiana,2003,M06,7.9,163785,2065517,1901732
South Dakota,2002,M03,4.0,16527,413068,396541
Virginia,2007,M10,2.9,119062,4047244,3928182
Texas,2015,M11,4.4,579425,13112474,12533049
South Dakota,2003,M06,3.5,14893,431173,416280
Minnesota,2001,M06,3.8,109713,2867385,2757672
California,2008,M03,6.6,1185778,18051542,16865764
North Carolina,2000,M03,3.5,145194,4120147,3974953
New Mexico,2004,M10,5.0,45814,910468,864654
Maine,2007,M11,4.6,32188,698458,666270
Oregon,2009,M08,11.0,218603,1988382,1769779
New Jersey,2011,M12,8.9,405508,4567795,4162287
Puerto Rico,2001,M07,10.8,135528,1249595,1114067
New Hampshire,2010,M12,5.3,38643,732968,694325
Pennsylvania,2005,M03,5.6,347136,6202448,5855312
Maryland,2009,M10,7.2,219419,3036374,2816955
Kentucky,2014,M07,6.7,134473,2017056,1882583
North Dakota,2009,M09,3.3,12178,367248,355070
Connecticut,2015,M07,5.9,112756,1919974,1807218
South Dakota,2008,M07,2.8,12979,456126,443147
Wisconsin,2002,M06,5.6,171593,3062334,2890741
Pennsylvania,2012,M08,8.3,541896,6510093,5968197
Louisiana,2008,M10,5.4,115326,2122897,2007571
Missouri,2001,M03,5.0,150284,3025528,2875244
Louisiana,2012,M07,7.8,165191,2117426,1952235
North Carolina,2009,M05,10.6,484666,4593856,4109190
Maryland,2004,M03,4.4,125868,2869301,2743433
Delaware,2005,M04,3.9,16606,427402,410796
Florida,2016,M01,5.0,485449,9668561,9183112
Illinois,2008,M10,6.4,420973,6613458,6192485
Indiana,2013,M02,9.0,284907,3162373,2877466
Alaska,2002,M10,6.9,22511,326432,303921
Washington,2014,M09,5.6,197212,3502381,3305169
Montana,2007,M01,3.9,19099,490223,471124
Missouri,2003,M04,5.2,156878,3025175,2868297
Texas,2003,M11,6.3,688886,10973106,10284220
Massachusetts,2011,M08,6.9,243136,3507557,3264421
California,2006,M06,4.9,859354,17647224,16787870
Connecticut,2006,M04,4.0,73125,1806055,1732930
Vermont,2009,M03,7.6,27401,360593,333192
Pennsylvania,2014,M03,6.6,420954,6385327,5964373
Wyoming,2012,M05,5.1,15614,305878,290264
Mississippi,2002,M04,6.3,81033,1279399,1198366
Michigan,2016,M11,4.2,203410,4845978,4642568
Pennsylvania,2011,M09,7.7,495586,6411802,5916216
Georgia,2000,M07,3.9,165992,4241173,4075181
Florida,2014,M03,6.5,626052,9571287,8945235
New Jersey,2002,M04,5.7,246943,4328651,4081708
South Dakota,2008,M02,3.1,13610,440148,426538
Indiana,2002,M12,4.8,152678,3157956,3005278
Idaho,2002,M07,4.9,33884,694543,660659
New York,2003,M09,6.3,577315,9188675,8611360
Washington,2010,M06,9.8,344103,3527416,3183313
Georgia,2008,M08,6.6,325861,4964017,4638156
Nevada,2011,M02,13.6,185903,1370619,1184716
Maryland,2013,M03,6.8,212724,3115437,2902713
Massachusetts,2009,M02,7.9,272365,3443134,3170769
Missouri,2004,M05,5.5,166223,3009263,2843040
Michigan,2013,M03,9.0,421041,4681477,4260436
Oregon,2000,M01,5.8,103720,1796556,1692836
South Dakota,2000,M11,2.6,10426,408015,397589
North Dakota,2010,M05,3.4,12846,379879,367033
California,2005,M06,5.4,940007,17532901,16592894
District of Columbia,2014,M11,7.6,28955,383042,354087
Louisiana,2007,M11,3.7,76362,2061880,1985518
Rhode Island,2013,M09,8.8,49362,558152,508790
Kentucky,2011,M10,8.6,176987,2049557,1872570
Massachusetts,2014,M04,5.5,193796,3514650,3320854
Connecticut,2001,M12,2.8,48312,1748766,1700454
Rhode Island,2012,M05,10.4,57373,553422,496049
Iowa,2005,M03,4.8,78044,1616060,1538016
Idaho,2007,M05,2.2,16951,754237,737286
Michigan,2008,M02,7.4,362378,4904475,4542097
Texas,2013,M10,6.0,766759,12855974,12089215
Florida,2005,M03,3.8,325166,8577972,8252806
Virginia,2011,M11,6.1,257476,4219509,3962033
Wisconsin,2009,M02,8.8,274248,3105799,2831551
Oregon,2007,M08,5.0,97154,1939512,1842358
Alaska,2016,M09,6.1,21892,360761,338869
Utah,2007,M12,2.6,35223,1369729,1334506
Alabama,2000,M06,4.9,104604,2144789,2040185
Kansas,2005,M09,4.8,69874,1458510,1388636
Nebraska,2009,M06,4.8,48467,1002878,954411
Montana,2003,M01,5.6,25938,464439,438501
Ohio,2002,M08,5.4,318804,5888969,5570165
Ohio,2005,M07,5.8,344837,5960825,5615988
Kansas,2004,M05,5.3,76495,1454781,1378286
Utah,2016,M03,3.8,57383,1494937,1437554
Utah,2011,M08,6.7,91102,1356401,1265299
New Jersey,2001,M04,3.6,154734,4248818,4094084
Alabama,2005,M08,4.5,97303,2150911,2053608
Wyoming,2011,M02,6.9,20817,303474,282657
Rhode Island,2016,M05,5.3,28907,548407,519500
Ohio,2007,M06,5.8,352025,6057169,5705144
New Hampshire,2016,M02,3.3,24367,743674,719307
Utah,2014,M03,4.2,59208,1420135,1360927
Oklahoma,2016,M03,4.8,87435,1832534,1745099
Texas,2008,M04,3.9,451636,11584272,11132636
New Jersey,2007,M08,4.1,180898,4455495,4274597
Texas,2002,M03,6.2,657376,10672063,10014687
Minnesota,2001,M05,3.2,90230,2836724,2746494
Mississippi,2012,M04,8.0,104902,1312599,1207697
Oregon,2007,M02,5.9,111270,1901222,1789952
Illinois,2001,M01,5.4,348479,6467273,6118794
South Dakota,2009,M02,5.2,23157,444140,420983
Vermont,2015,M08,3.4,11935,348151,336216
Vermont,2013,M04,4.7,16198,348046,331848
Virginia,2010,M11,6.7,280787,4160174,3879387
Hawaii,2003,M03,3.8,23032,601391,578359
Tennessee,2012,M12,7.7,237531,3098401,2860870
Alaska,2008,M08,5.8,20912,362908,341996
Kentucky,2000,M04,3.7,72123,1964265,1892142
Michigan,2006,M10,6.3,317776,5067850,4750074
District of Columbia,2009,M11,10.0,34114,339461,305347
Nevada,2014,M05,7.8,109097,1394006,1284909
Massachusetts,2012,M06,6.9,242997,3530345,3287348
Nebraska,2012,M02,4.5,44889,1004919,960030
Iowa,2002,M08,3.8,62695,1641718,1579023
Puerto Rico,2004,M08,11.4,154872,1356604,1201732
Illinois,2012,M10,8.6,566372,6616294,6049922
New York,2007,M11,4.4,424968,9563675,9138707
Mississippi,2013,M06,9.5,123122,1289955,1166833
Puerto Rico,2003,M09,12.2,160325,1312677,1152352
Minnesota,2005,M12,4.0,114975,2879710,2764735
Wyoming,2004,M09,3.4,9322,274793,265471
Virginia,2004,M06,4.2,158779,3822500,3663721
Iowa,2013,M10,4.1,69769,1685402,1615633
Iowa,2009,M07,6.4,109042,1708314,1599272
New Hampshire,2001,M12,3.9,27201,695488,668287
New Mexico,2009,M09,7.6,71249,935068,863819
Delaware,2014,M04,5.8,26128,448782,422654
New Hampshire,2006,M06,3.4,24991,739298,714307
Kentucky,2009,M12,10.1,205414,2042030,1836616
Ohio,2014,M02,7.2,406555,5654478,5247923
Rhode Island,2013,M11,8.8,49138,560363,511225
Iowa,2004,M11,4.2,67857,1610818,1542961
South Dakota,2001,M10,2.9,12133,414720,402587
Minnesota,2008,M02,5.3,154189,2885213,2731024
Kansas,2014,M07,5.1,77547,1516046,1438499
Wisconsin,2014,M02,6.8,209891,3067050,2857159
Illinois,2002,M02,6.8,438115,6396548,5958433
Idaho,2014,M08,4.7,36684,787126,750442
Wisconsin,2011,M02,9.1,278314,3070527,2792213
Wyoming,2000,M08,3.4,9249,270628,261379
Utah,2015,M11,3.1,46079,1479558,1433479
Louisiana,2016,M04,5.7,121287,2127276,2005989
Colorado,2008,M11,5.3,144918,2723709,2578791
Puerto Rico,2013,M01,14.9,178884,1197563,1018679
Wisconsin,2003,M08,5.5,167441,3064808,2897367
North Carolina,2014,M12,5.4,251827,4669234,4417407
Virginia,2011,M02,6.9,286431,4167912,3881481
Colorado,2000,M06,3.0,71098,2380402,2309304
Delaware,2008,M01,4.4,19752,445940,426188
District of Columbia,2013,M10,8.7,32305,372088,339783
Alaska,2000,M07,5.5,18212,330185,311973
Illinois,2000,M01,4.7,306286,6473576,6167290
District of Columbia,2014,M02,8.2,30611,372928,342317
Delaware,2003,M08,4.4,18530,418418,399888
South Carolina,2008,M12,9.1,194839,2142475,1947636
Delaware,2016,M08,4.5,21262,474958,453696
Illinois,2014,M09,6.2,400856,6476122,6075266
Arkansas,2009,M02,8.1,109615,1360211,1250596
Wisconsin,2006,M07,4.7,145075,3103098,2958023
Ohio,2001,M09,4.2,244825,5808854,5564029
Minnesota,2004,M09,4.3,124189,2882361,2758172
Oklahoma,2012,M12,5.2,94130,1810316,1716186
Puerto Rico,2000,M10,10.1,127720,1265736,1138016
New York,2004,M10,5.1,479071,9393922,8914851
Montana,2011,M02,8.3,40898,494793,453895
Michigan,2005,M01,7.5,376553,5008904,4632351
New Hampshire,2002,M05,4.3,29647,696856,667209
Texas,2003,M09,6.7,728228,10911389,10183161
West Virginia,2012,M04,7.3,58716,807322,748606
Oklahoma,2010,M04,6.5,114276,1769287,1655011
Missouri,2012,M08,7.2,215507,3011970,2796463
North Dakota,2001,M08,2.6,9060,346529,337469
Indiana,2008,M01,5.3,168288,3196979,3028691
Alabama,2010,M03,11.5,245567,2137573,1892006
Hawaii,2002,M09,4.2,24796,595785,570989
Montana,2006,M05,3.2,15825,494700,478875
Texas,2006,M10,4.3,495411,11406025,10910614
Utah,2011,M11,5.6,75383,1352548,1277165
Colorado,2003,M06,6.3,158654,2508813,2350159
Kansas,2014,M02,5.1,76720,1490903,1414183
Illinois,2002,M07,6.9,443303,6407921,5964618
Michigan,2004,M01,7.5,375863,5006840,4630977
Michigan,2016,M10,4.8,234794,4868988,4634194
Wyoming,2004,M06,3.7,10468,280396,269928
Arkansas,2004,M07,6.1,80572,1321577,1241005
Mississippi,2008,M03,5.8,75569,1312045,1236476
Utah,2000,M01,3.4,37629,1122721,1085092
North Carolina,2015,M03,5.6,266818,4741838,4475020
Kansas,2011,M01,7.4,110272,1491402,1381130
Indiana,2005,M06,5.4,173522,3233412,3059890
Delaware,2011,M07,7.6,33846,448198,414352
West Virginia,2012,M01,8.1,64369,795922,731553
Oklahoma,2010,M01,7.6,132864,1749387,1616523
Washington,2013,M12,6.6,228942,3450281,3221339
Idaho,2014,M09,4.2,32683,781008,748325
Hawaii,2003,M04,3.9,23565,603058,579493
Kentucky,2000,M03,4.6,89699,1969478,1879779
Florida,2005,M10,3.4,297884,8843571,8545687
Utah,2006,M02,3.8,48808,1294797,1245989
Nevada,2007,M11,4.6,62498,1345511,1283013
California,2013,M05,8.6,1595134,18611474,17016340
Georgia,2007,M03,4.0,191268,4782836,4591568
Wyoming,2007,M06,3.0,8758,292137,283379
Montana,2002,M06,4.4,20735,474667,453932
Puerto Rico,2003,M10,11.7,155574,1331782,1176208
North Carolina,2012,M08,9.6,449129,4671873,4222744
Pennsylvania,2008,M06,5.3,343216,6511635,6168419
Ohio,2013,M12,6.5,365968,5663529,5297561
Wyoming,2002,M08,3.4,9229,271971,262742
Virginia,2004,M05,3.8,145304,3789626,3644322
Nebraska,2003,M04,3.9,37253,964899,927646
Louisiana,2015,M06,7.0,154559,2197021,2042462
Mississippi,2007,M03,6.0,77243,1290037,1212794
South Dakota,2006,M03,3.5,15011,428948,413937
North Carolina,2004,M03,5.9,250118,4237817,3987699
Massachusetts,2015,M09,4.7,165567,3554620,3389053
Illinois,2015,M03,6.0,387216,6444909,6057693
Connecticut,2002,M08,4.7,83675,1797874,1714199
Rhode Island,2012,M04,10.4,57706,552556,494850
Michigan,2006,M04,6.8,343211,5042038,4698827
South Dakota,2016,M07,2.6,11911,462389,450478
South Carolina,2003,M07,7.2,146902,2028815,1881913
Kansas,2009,M08,7.3,111437,1516769,1405332
New York,2015,M04,5.3,503889,9578416,9074527
Arkansas,2015,M05,5.4,71701,1338244,1266543
New Mexico,2009,M12,7.4,69032,933665,864633
Nevada,2009,M08,11.7,158218,1347013,1188795
Minnesota,2009,M06,8.2,244630,2976316,2731686
Nevada,2004,M11,4.0,47461,1193762,1146301
North Dakota,2012,M04,3.1,12057,393772,381715
New Jersey,2006,M08,4.7,210588,4484647,4274059
Pennsylvania,2015,M12,4.7,297838,6397621,6099783
West Virginia,2009,M08,8.0,65521,818198,752677
South Carolina,2016,M10,4.5,102913,2299345,2196432
Oklahoma,2015,M08,4.3,79552,1829379,1749827
District of Columbia,2005,M09,5.8,18131,313407,295276
North Carolina,2006,M12,4.5,200462,4500569,4300107
Virginia,2001,M02,2.7,98345,3651583,3553238
Montana,2000,M04,5.1,23699,467251,443552
Wisconsin,2010,M06,8.7,270767,3120226,2849459
South Dakota,2009,M03,5.6,25011,446921,421910
Nevada,2002,M02,6.2,69985,1125123,1055138
Minnesota,2013,M11,4.1,119609,2950500,2830891
Minnesota,2010,M11,6.7,197739,2940752,2743013
Minnesota,2015,M02,4.5,132973,2956384,2823411
New Jersey,2016,M10,4.6,205724,4505268,4299544
Massachusetts,2001,M10,3.7,126790,3384528,3257738
Massachusetts,2003,M07,5.9,205636,3462433,3256797
Mississippi,2009,M09,9.8,122485,1255560,1133075
South Dakota,2012,M09,3.9,17004,440854,423850
West Virginia,2005,M11,4.4,35263,795483,760220
Montana,2008,M01,5.2,26144,501924,475780
Oklahoma,2003,M11,5.2,87704,1692211,1604507
North Carolina,2014,M09,5.8,274008,4688669,4414661
Vermont,2006,M05,3.3,11556,353764,342208
Minnesota,2004,M10,3.9,111155,2885381,2774226
California,2006,M09,4.6,814937,17691390,16876453
Illinois,2014,M10,6.1,395703,6511336,6115633
Alaska,2011,M12,7.8,28299,363580,335281
Florida,2010,M03,11.0,1006869,9114245,8107376
Rhode Island,2011,M04,10.7,59351,555939,496588
Idaho,2015,M03,4.7,36979,786827,749848
Minnesota,2010,M06,7.3,215826,2957785,2741959
West Virginia,2015,M03,7.7,59707,776224,716517
Oklahoma,2009,M03,6.0,105832,1754567,1648735
Montana,2004,M01,6.0,28322,469421,441099
Montana,2003,M07,4.2,20394,480234,459840
California,2014,M06,7.4,1393023,18744815,17351792
Minnesota,2015,M08,3.3,99779,2984121,2884342
Arizona,2014,M05,6.6,204455,3074731,2870276
Maine,2011,M02,9.3,63837,689325,625488
Nebraska,2013,M08,3.6,37215,1020775,983560
Idaho,2005,M01,5.6,40362,715053,674691
Michigan,2009,M03,13.3,651300,4886998,4235698
Wisconsin,2005,M06,4.9,149878,3059925,2910047
North Carolina,2002,M02,7.1,296844,4191610,3894766
New Jersey,2000,M09,3.6,152147,4235444,4083297
Colorado,2010,M08,8.6,236200,2743447,2507247
Alaska,2014,M03,7.6,27637,362052,334415
Arizona,2013,M02,7.6,229128,3013596,2784468
Minnesota,2009,M11,7.2,209607,2928920,2719313
Hawaii,2011,M05,6.7,44107,662454,618347
South Dakota,2000,M07,2.2,9348,417367,408019
Iowa,2000,M04,2.4,38022,1588181,1550159
Nebraska,2000,M10,2.6,24383,945476,921093
Texas,2010,M05,7.9,960234,12220312,11260078
South Carolina,2015,M04,5.8,130454,2263078,2132624
South Carolina,2009,M03,10.9,233805,2150068,1916263
Maine,2007,M03,5.2,35744,693406,657662
Oregon,2011,M10,8.9,177196,1996287,1819091
West Virginia,2002,M11,5.5,43843,792603,748760
Oklahoma,2004,M11,4.6,78253,1704050,1625797
Iowa,2001,M03,3.8,60748,1605864,1545116
Idaho,2003,M01,6.8,46608,683929,637321
Colorado,2009,M09,7.3,199250,2722304,2523054
Nevada,2011,M12,12.3,168123,1372017,1203894
Florida,2001,M03,3.9,312674,8044166,7731492
Wisconsin,2002,M02,6.5,196271,3015973,2819702
New Jersey,2004,M01,5.9,255101,4336472,4081371
Maryland,2014,M06,6.1,191439,3153297,2961858
Puerto Rico,2012,M05,13.7,163681,1194456,1030775
Kansas,2009,M04,6.5,97977,1516630,1418653
North Dakota,2001,M11,2.7,9094,335148,326054
Florida,2012,M09,8.3,787259,9481718,8694459
California,2013,M06,9.2,1722623,18703284,16980661
Alabama,2013,M10,7.0,152300,2164301,2012001
Idaho,2001,M04,5.4,35992,671826,635834
Vermont,2008,M01,5.0,17598,351409,333811
Missouri,2007,M06,5.2,160412,3076343,2915931
Illinois,2014,M11,6.0,389704,6491621,6101917
Wyoming,2007,M11,2.6,7454,288931,281477
Montana,2002,M04,4.6,21508,465344,443836
New York,2006,M10,3.9,369322,9503554,9134232
Michigan,2000,M03,3.8,197859,5164570,4966711
Minnesota,2001,M02,4.0,113052,2820132,2707080
Ohio,2011,M06,9.4,548916,5826772,5277856
Delaware,2016,M11,3.8,18029,470281,452252
Utah,2010,M03,8.4,113032,1350123,1237091
Connecticut,2001,M04,2.9,51363,1747597,1696234
New Hampshire,2003,M03,4.8,33743,701864,668121
Wisconsin,2003,M12,4.9,149576,3036110,2886534
New Jersey,2002,M01,6.0,259079,4307008,4047929
Pennsylvania,2009,M02,8.2,527957,6426962,5899005
Colorado,2005,M02,5.7,144504,2536420,2391916
Massachusetts,2015,M01,5.8,206764,3556417,3349653
Maine,2016,M03,4.5,30469,677706,647237
Florida,2008,M07,6.8,631543,9312115,8680572
North Carolina,2009,M12,11.0,495639,4509710,4014071
Massachusetts,2008,M06,5.6,196055,3498146,3302091
West Virginia,2005,M07,5.1,41223,802446,761223
Oklahoma,2003,M07,5.6,94760,1697561,1602801
Iowa,2007,M09,3.4,56121,1660723,1604602
Puerto Rico,2008,M01,11.0,148392,1349140,1200748
Illinois,2003,M01,7.3,455300,6256389,5801089
Rhode Island,2015,M05,6.0,33364,552103,518739
Nevada,2007,M10,4.5,60397,1339322,1278925
Pennsylvania,2006,M10,3.9,244384,6303656,6059272
Wyoming,2004,M11,3.7,10109,274864,264755
Tennessee,2004,M09,5.3,151439,2863270,2711831
New York,2005,M08,4.7,445045,9567626,9122581
Maine,2013,M05,6.7,46897,704445,657548
Arkansas,2014,M12,5.5,72664,1311164,1238500
Idaho,2006,M04,3.9,29146,742943,713797
Montana,2000,M03,5.9,27404,466539,439135
California,2016,M02,5.8,1096284,19041291,17945007
North Carolina,2002,M11,6.5,272086,4160558,3888472
Utah,2011,M06,7.0,95303,1353502,1258199
Alabama,2014,M01,7.5,162341,2151800,1989459
Georgia,2010,M05,10.1,469745,4672893,4203148
Kansas,2007,M02,4.6,67224,1471835,1404611
Alaska,2007,M08,5.4,19082,356641,337559
Indiana,2002,M09,4.4,139419,3177894,3038475
Virginia,2012,M06,6.4,271774,4256432,3984658
New York,2010,M11,8.4,800042,9518599,8718557
Connecticut,2016,M08,5.2,98951,1907030,1808079
Mississippi,2008,M12,7.6,98955,1296224,1197269
Oregon,2014,M04,6.8,129973,1913659,1783686
Virginia,2010,M09,6.8,284462,4174110,3889648
New Hampshire,2002,M11,4.4,30651,702451,671800
Alaska,2008,M11,6.8,23955,353954,329999
Tennessee,2015,M12,4.8,146609,3083677,2937068
New York,2003,M10,6.2,574985,9240652,8665667
Iowa,2002,M01,4.8,76969,1618427,1541458
Tennessee,2016,M03,4.5,139548,3105299,2965751
Minnesota,2000,M04,2.9,82034,2793985,2711951
Vermont,2002,M05,3.6,12378,340380,328002
Arkansas,2002,M12,5.4,67862,1265120,1197258
Colorado,2008,M06,4.9,134852,2737640,2602788
North Carolina,2006,M11,4.7,214579,4525206,4310627
Nebraska,2015,M10,2.8,28434,1009032,980598
Montana,2010,M09,6.4,31849,499798,467949
Michigan,2000,M12,3.7,192053,5181821,4989768
New Jersey,2012,M12,8.9,406001,4582310,4176309
Arkansas,2002,M05,5.5,69660,1277399,1207739
West Virginia,2008,M04,4.4,35564,814929,779365
Colorado,2007,M10,3.5,93972,2694021,2600049
Oklahoma,2014,M04,4.1,72924,1774941,1702017
Alabama,2007,M05,3.3,72062,2158625,2086563
Washington,2015,M03,5.8,204282,3524104,3319822
West Virginia,2005,M12,4.3,34185,790906,756721
Maryland,2000,M02,3.8,105387,2765612,2660225
Louisiana,2010,M02,7.2,147204,2035087,1887883
Georgia,2001,M07,4.0,170477,4263961,4093484
Oklahoma,2003,M12,5.1,85068,1678754,1593686
Delaware,2014,M06,6.1,28008,457547,429539
Florida,2012,M12,7.8,735933,9397211,8661278
Alaska,2011,M11,7.4,27115,364224,337109
Illinois,2004,M11,5.8,369238,6368096,5998858
Michigan,2007,M01,7.7,386297,5013249,4626952
North Dakota,2005,M07,3.1,11438,363380,351942
Vermont,2008,M09,4.5,15937,355499,339562
Hawaii,2001,M10,5.3,31993,605545,573552
Mississippi,2016,M12,5.7,73153,1289299,1216146
Pennsylvania,2007,M01,5.0,317252,6291592,5974340
Kentucky,2005,M05,5.9,117653,2004386,1886733
Iowa,2006,M10,3.2,53737,1672595,1618858
Texas,2004,M10,5.6,615958,11033817,10417859
Colorado,2011,M06,8.3,227272,2739952,2512680
District of Columbia,2016,M05,5.4,21042,388784,367742
Connecticut,2010,M05,8.9,170377,1914400,1744023
Delaware,2016,M06,4.7,22505,477351,454846
Utah,2002,M09,5.7,67267,1189681,1122414
Arizona,2001,M01,4.3,108704,2546783,2438079
New Mexico,2008,M05,3.9,36834,937341,900507
Maryland,2012,M09,6.7,209115,3122954,2913839
New Jersey,2000,M12,3.3,141006,4281863,4140857
North Dakota,2012,M02,3.8,14833,389329,374496
Mississippi,2014,M08,7.4,91339,1238929,1147590
Colorado,2012,M05,7.9,215284,2741044,2525760
California,2001,M02,5.1,866086,17100781,16234695
Delaware,2001,M06,3.5,14902,425167,410265
Alabama,2016,M01,6.3,134592,2141628,2007036
Illinois,2005,M11,5.2,335862,6434399,6098537
North Carolina,2000,M10,3.7,153358,4150320,3996962
West Virginia,2009,M12,8.1,64642,800282,735640
Oklahoma,2015,M12,4.3,79353,1832130,1752777
New Mexico,2004,M03,5.8,51776,893467,841691
North Carolina,2001,M12,6.5,272964,4176376,3903412
Georgia,2011,M03,10.0,470617,4713093,4242476
Tennessee,2006,M07,5.8,178202,3090293,2912091
Wyoming,2003,M06,4.2,11693,279150,267457
Wisconsin,2014,M07,5.5,170898,3129343,2958445
Wisconsin,2014,M03,6.6,202866,3068174,2865308
District of Columbia,2012,M05,8.6,31050,359712,328662
Maryland,2014,M11,5.4,169247,3134240,2964993
West Virginia,2010,M01,9.4,75614,802977,727363
Arizona,2004,M04,5.1,140951,2771850,2630899
Pennsylvania,2007,M12,4.4,282494,6376881,6094387
Oklahoma,2012,M01,5.8,103634,1775017,1671383
Florida,2003,M08,5.6,463267,8238790,7775523
Rhode Island,2004,M10,4.3,24287,558954,534667
Alabama,2000,M11,4.4,94639,2138247,2043608
Arizona,2010,M07,10.8,332603,3088705,2756102
Washington,2014,M11,6.0,209473,3515666,3306193
Hawaii,2014,M11,4.1,27587,670733,643146
Montana,2009,M05,6.4,32221,501265,469044
North Carolina,2016,M07,5.2,257157,4903825,4646668
Wyoming,2012,M10,4.8,14863,307263,292400
Hawaii,2003,M12,3.6,21762,604513,582751
Maine,2004,M12,4.7,31893,685682,653789
Mississippi,2006,M06,7.0,90975,1300984,1210009
Illinois,2011,M03,9.5,622423,6533730,5911307
Tennessee,2012,M03,7.9,243509,3088488,2844979
Puerto Rico,2015,M07,11.2,123076,1103583,980507
New York,2016,M09,4.9,471384,9554863,9083479
Maryland,2003,M02,4.8,136560,2851926,2715366
Arkansas,2011,M09,7.9,107718,1363406,1255688
Michigan,2002,M04,6.2,307336,4977562,4670226
Puerto Rico,2005,M10,12.5,173498,1386419,1212921
Ohio,2010,M11,9.4,548930,5818921,5269991
West Virginia,2007,M10,4.0,32968,816779,783811
Kentucky,2000,M07,4.2,83079,1973497,1890418
Iowa,2016,M04,3.5,58931,1699546,1640615
West Virginia,2006,M02,5.7,45003,795490,750487
Oklahoma,2001,M10,4.2,70425,1687683,1617258
Oklahoma,2000,M02,3.5,57321,1648087,1590766
Louisiana,2007,M06,5.1,105625,2061741,1956116
Puerto Rico,2002,M12,10.9,143426,1310872,1167446
Delaware,2010,M02,9.4,40140,427433,387293
Arizona,2004,M05,4.9,135762,2770618,2634856
Michigan,2003,M10,6.5,326384,5032730,4706346
North Dakota,2011,M01,4.4,16503,377971,361468
Indiana,2009,M12,10.7,334172,3129947,2795775
New York,2008,M07,5.4,534071,9813194,9279123
North Dakota,2008,M04,3.1,11381,369878,358497
Arkansas,2005,M12,4.9,66797,1353586,1286789
Maine,2001,M05,3.8,25454,670337,644883
Vermont,2001,M07,3.2,10813,342213,331400
Rhode Island,2005,M03,5.5,30732,557500,526768
Tennessee,2007,M04,4.0,122398,3040459,2918061
Massachusetts,2005,M12,4.6,156125,3383404,3227279
Wisconsin,2004,M09,4.1,124857,3017398,2892541
Arizona,2010,M01,11.1,343882,3107217,2763335
South Dakota,2000,M05,2.3,9397,410025,400628
Wisconsin,2006,M06,4.9,152679,3102932,2950253
Pennsylvania,2008,M08,5.6,363981,6526540,6162559
South Carolina,2012,M11,8.2,177723,2173493,1995770
Texas,2011,M11,7.1,893500,12595757,11702257
Arizona,2001,M04,4.1,104576,2560715,2456139
California,2002,M02,6.8,1166825,17270098,16103273
Alabama,2004,M10,5.5,119278,2154983,2035705
West Virginia,2014,M08,6.6,52421,789203,736782
Oklahoma,2008,M08,3.8,65950,1754977,1689027
Virginia,2007,M05,2.8,114403,4029767,3915364
Wyoming,2005,M03,3.9,10611,272834,262223
Hawaii,2005,M07,2.9,18713,634474,615761
Louisiana,2001,M09,5.8,116472,2016445,1899973
Tennessee,2016,M07,5.2,163765,3173928,3010163
New Mexico,2008,M12,5.2,48927,949075,900148
Maine,2014,M07,5.2,37275,713453,676178
West Virginia,2011,M03,8.9,71545,801157,729612
Oklahoma,2013,M03,5.1,92553,1800289,1707736
Vermont,2014,M10,3.2,11145,346577,335432
Massachusetts,2015,M08,4.6,166670,3615992,3449322
Connecticut,2002,M09,4.5,80331,1778003,1697672
Hawaii,2008,M05,3.7,23808,642800,618992
North Dakota,2004,M10,2.6,9193,354060,344867
Mississippi,2006,M04,5.9,74629,1275542,1200913
Kentucky,2013,M09,7.8,159267,2053412,1894145
Iowa,2011,M02,6.4,107685,1669746,1562061
South Carolina,2010,M01,12.4,264804,2129893,1865089
Washington,2007,M05,4.5,150730,3379192,3228462
Alaska,2006,M08,5.5,19730,356207,336477
Mississippi,2016,M02,5.9,75774,1274871,1199097
Florida,2004,M12,4.2,358172,8553144,8194972
Wisconsin,2001,M06,4.8,146133,3055255,2909122
Kentucky,2011,M11,8.3,171375,2053165,1881790
Michigan,2015,M12,4.4,210115,4758781,4548666
Minnesota,2012,M01,6.6,191898,2915844,2723946
Tennessee,2003,M02,5.7,164776,2908145,2743369
Alaska,2010,M03,8.9,31867,357402,325535
Utah,2004,M10,4.4,55254,1244558,1189304
Arizona,2016,M02,5.3,171147,3214959,3043812
Utah,2000,M07,3.6,41638,1152191,1110553
Florida,2008,M05,5.5,509946,9224844,8714898
Vermont,2009,M12,6.1,21713,357681,335968
Oregon,2002,M09,6.5,119700,1843891,1724191
Louisiana,2015,M11,5.7,121158,2142619,2021461
Delaware,2016,M05,4.1,19240,471888,452648
Massachusetts,2002,M02,5.3,179444,3403296,3223852
South Carolina,2005,M03,6.4,129621,2034905,1905284
Connecticut,2009,M12,8.3,156142,1881240,1725098
Nebraska,2009,M09,4.6,45698,984225,938527
Florida,2011,M12,9.0,834614,9305007,8470393
Arizona,2001,M09,5.5,142930,2612140,2469210
Wisconsin,2013,M06,7.1,221983,3134678,2912695
Louisiana,2016,M02,5.8,121977,2110065,1988088
Hawaii,2016,M01,3.1,21331,680740,659409
Missouri,2014,M07,6.5,201120,3088409,2887289
North Carolina,2011,M10,9.9,461826,4662429,4200603
Alaska,2013,M04,7.1,25490,359701,334211
Michigan,2003,M05,7.2,361863,5031926,4670063
West Virginia,2002,M02,6.7,53891,801181,747290
Oklahoma,2004,M02,5.4,90573,1672711,1582138
Montana,2002,M11,4.4,20308,466070,445762
Illinois,2002,M04,6.5,414583,6354905,5940322
Massachusetts,2010,M04,8.3,288876,3475194,3186318
Vermont,2005,M05,3.1,10632,346150,335518
Delaware,2016,M04,4.3,20229,473738,453509
Georgia,2003,M09,4.6,202181,4384847,4182666
South Dakota,2002,M02,3.9,15787,409745,393958
Connecticut,2001,M11,2.9,50723,1754859,1704136
Kansas,2011,M05,6.4,94418,1483821,1389403
Nevada,2000,M01,4.5,46721,1041009,994288
Nevada,2000,M08,4.0,42918,1076547,1033629
Maryland,2006,M06,4.3,128930,2996595,2867665
Arkansas,2009,M07,8.2,113433,1381236,1267803
Montana,2015,M02,5.0,25407,512760,487353
New Hampshire,2007,M03,4.1,30111,735847,705736
Colorado,2009,M10,7.4,201590,2719225,2517635
Kentucky,2014,M12,5.0,97621,1972032,1874411
Wisconsin,2005,M08,4.3,129468,3045355,2915887
New Jersey,2014,M03,7.4,331879,4498920,4167041
Pennsylvania,2003,M05,5.6,342331,6151673,5809342
Texas,2010,M01,8.6,1039130,12035309,10996179
Alaska,2015,M05,6.3,23010,364021,341011
South Carolina,2015,M09,5.6,127761,2264443,2136682
Ohio,2003,M06,7.0,414263,5953900,5539637
Tennessee,2002,M10,4.4,129786,2918347,2788561
Pennsylvania,2000,M12,3.8,235081,6130562,5895481
North Dakota,2001,M10,2.2,7384,339482,332098
Alabama,2009,M02,10.5,227822,2171529,1943707
Ohio,2009,M03,10.3,609409,5903926,5294517
Hawaii,2006,M04,2.7,17493,637641,620148
North Dakota,2014,M08,2.5,10417,423943,413526
Ohio,2009,M02,10.2,603573,5911644,5308071
Mississippi,2000,M04,4.9,65236,1320244,1255008
Utah,2003,M12,4.9,59337,1210608,1151271
Montana,2005,M05,4.0,19283,484621,465338
Vermont,2009,M04,7.5,26860,357774,330914
Texas,2006,M08,5.0,565943,11347991,10782048
Tennessee,2012,M11,7.1,217832,3088940,2871108
Texas,2016,M09,4.8,646980,13359661,12712681
New Mexico,2015,M07,7.2,66661,928114,861453
Iowa,2014,M08,4.2,72505,1707321,1634816
New Hampshire,2009,M12,6.0,44534,737192,692658
Kentucky,2001,M12,5.6,109868,1952798,1842930
Mississippi,2013,M01,10.0,129105,1284841,1155736
Massachusetts,2000,M02,3.3,111032,3324794,3213762
Virginia,2014,M02,5.7,241097,4241632,4000535
Nebraska,2001,M01,3.4,31592,938065,906473
New York,2010,M04,8.5,816515,9648949,8832434
Iowa,2003,M06,4.6,75329,1620382,1545053
Kansas,2000,M07,3.9,54821,1422701,1367880
Wyoming,2013,M02,5.6,17010,303316,286306
Mississippi,2009,M06,9.9,127016,1281487,1154471
Alaska,2011,M01,8.7,31477,360755,329278
Oregon,2003,M03,8.8,160917,1838541,1677624
North Carolina,2014,M10,5.7,267677,4728654,4460977
Virginia,2008,M06,4.0,166028,4174547,4008519
Connecticut,2000,M07,2.6,47007,1796771,1749764
Nebraska,2008,M03,3.3,32197,983667,951470
Nevada,2014,M07,8.1,112955,1401642,1288687
Louisiana,2005,M07,6.2,130711,2113199,1982488
South Carolina,2001,M10,5.7,111085,1939250,1828165
Colorado,2000,M11,2.6,62403,2363957,2301554
Illinois,2009,M12,11.0,720556,6557067,5836511
Massachusetts,2014,M03,6.2,219722,3525884,3306162
New Mexico,2013,M02,7.2,66366,926385,860019
Idaho,2010,M08,8.4,64538,765414,700876
Florida,2014,M10,5.9,570852,9647025,9076173
Minnesota,2001,M12,4.3,121022,2844065,2723043
Mississippi,2011,M11,9.1,121039,1336526,1215487
New Hampshire,2005,M12,3.2,22989,725819,702830
Florida,2008,M06,6.2,571015,9251174,8680159
Iowa,2004,M06,4.5,73007,1613058,1540051
Minnesota,2014,M05,3.9,114081,2957497,2843416
Massachusetts,2008,M07,5.7,199372,3509150,3309778
Louisiana,2010,M05,7.6,160108,2093399,1933291
West Virginia,2015,M08,6.7,53018,787186,734168
Oklahoma,2009,M08,6.6,117820,1772752,1654932
New Mexico,2012,M11,6.8,63408,936783,873375
New York,2012,M09,8.0,770858,9607579,8836721
Ohio,2008,M02,5.9,350844,5901215,5550371
Hawaii,2012,M05,6.1,39603,646714,607111
Washington,2011,M03,9.9,341199,3462275,3121076
Kentucky,2006,M05,5.6,113589,2026724,1913135
Texas,2009,M05,7.3,868282,11882121,11013839
Vermont,2003,M08,3.8,13462,349730,336268
Vermont,2015,M04,3.7,12823,342185,329362
Vermont,2013,M08,4.2,14771,354274,339503
Virginia,2014,M04,4.8,204329,4253715,4049386
New York,2007,M06,4.5,429851,9594261,9164410
Florida,2003,M12,4.5,368694,8258053,7889359
Arizona,2001,M10,5.3,138188,2619804,2481616
Nebraska,2009,M10,4.4,43285,989561,946276
Texas,2008,M08,5.2,607364,11702285,11094921
Maine,2016,M02,4.7,31502,674135,642633
New Jersey,2007,M04,4.2,183160,4403609,4220449
Oregon,2008,M10,7.2,141798,1977116,1835318
Missouri,2008,M08,6.8,205860,3034369,2828509
Iowa,2005,M02,5.1,82966,1611038,1528072
Colorado,2013,M07,6.8,191479,2802596,2611117
South Carolina,2014,M12,6.4,143637,2236334,2092697
District of Columbia,2016,M02,6.5,25650,392467,366817
Hawaii,2015,M02,3.9,26042,670512,644470
Louisiana,2004,M11,5.5,113520,2057479,1943959
California,2007,M03,5.2,932960,17817285,16884325
New Mexico,2001,M05,4.6,39443,852251,812808
Vermont,2016,M12,2.8,9760,343751,333991
Maine,2016,M04,4.0,27289,680347,653058
Florida,2015,M06,5.6,543327,9642035,9098708
New Jersey,2007,M02,4.7,208234,4420129,4211895
District of Columbia,2013,M05,8.2,30414,371746,341332
Missouri,2005,M10,4.6,138631,3012002,2873371
Mississippi,2000,M01,6.1,79575,1311348,1231773
Hawaii,2006,M02,2.5,16126,632903,616777
Kentucky,2011,M12,8.4,171265,2050469,1879204
Georgia,2008,M10,7.2,342767,4780324,4437557
Delaware,2005,M02,4.5,18918,420900,401982
Massachusetts,2008,M02,5.2,175405,3402093,3226688
Washington,2005,M12,5.1,168935,3284711,3115776
Maine,2015,M08,3.5,24243,697279,673036
South Carolina,2000,M02,4.1,81161,1977705,1896544
Puerto Rico,2007,M11,11.1,150905,1355456,1204551
Maine,2001,M07,3.7,25588,692573,666985
Vermont,2001,M05,3.0,10071,333464,323393
New Mexico,2000,M03,5.1,42481,836752,794271
Colorado,2002,M01,5.9,143109,2406074,2262965
Connecticut,2005,M02,5.4,95053,1766893,1671840
Massachusetts,2000,M11,2.3,75993,3332438,3256445
Colorado,2006,M10,3.6,95699,2654235,2558536
Pennsylvania,2008,M12,6.3,404608,6462934,6058326
South Carolina,2010,M06,11.2,244208,2184631,1940423
Iowa,2008,M09,4.0,68054,1680431,1612377
Montana,2006,M02,4.5,21898,485433,463535
Delaware,2000,M04,3.6,14815,410042,395227
South Dakota,2002,M04,3.3,13666,414560,400894
Delaware,2016,M01,4.9,23227,471876,448649
New Jersey,2000,M04,3.3,141498,4274789,4133291
Connecticut,2003,M01,5.8,103012,1775238,1672226
Tennessee,2008,M03,5.9,178592,3037444,2858852
Maine,2014,M05,5.7,39353,694960,655607
Nebraska,2014,M02,3.9,39040,1010371,971331
Washington,2009,M12,10.5,369429,3518357,3148928
Rhode Island,2002,M10,4.5,25096,553658,528562
South Carolina,2003,M01,7.4,144824,1968431,1823607
Louisiana,2012,M01,8.0,163071,2039034,1875963
Arkansas,2007,M02,5.8,78735,1359991,1281256
North Carolina,2013,M06,8.6,404913,4719525,4314612
Puerto Rico,2000,M09,9.7,123815,1270088,1146273
District of Columbia,2011,M07,10.7,38302,358056,319754
Minnesota,2006,M12,4.2,121680,2891178,2769498
Alaska,2000,M12,6.5,20591,316319,295728
Tennessee,2007,M11,5.0,152935,3072380,2919445
New Mexico,2015,M03,6.5,59712,920115,860403
Hawaii,2000,M11,4.0,24160,607090,582930
Mississippi,2014,M06,8.4,105565,1260579,1155014
North Dakota,2015,M08,2.6,10905,419415,408510
North Dakota,2015,M01,3.4,13793,411305,397512
New Mexico,2010,M09,8.0,74453,932666,858213
West Virginia,2001,M08,4.7,37782,807189,769407
Virginia,2007,M06,3.1,125924,4064778,3938854
Kentucky,2004,M10,4.5,88507,1958436,1869929
Oklahoma,2007,M08,3.9,66966,1722489,1655523
Rhode Island,2009,M03,11.4,64477,564868,500391
Ohio,2009,M12,10.8,625935,5820763,5194828
Kansas,2013,M08,5.5,81922,1483126,1401204
Connecticut,2011,M10,8.2,156465,1910440,1753975
Minnesota,2009,M01,7.9,230511,2923930,2693419
Nebraska,2000,M05,2.8,26152,948670,922518
Massachusetts,2011,M02,8.1,279796,3449259,3169463
Pennsylvania,2006,M01,5.2,321512,6214528,5893016
Kentucky,2009,M10,10.0,203595,2045564,1841969
Oregon,2011,M05,9.1,181396,1986081,1804685
New Jersey,2002,M08,5.6,243582,4366569,4122987
Connecticut,2004,M10,4.4,78147,1774197,1696050
Arkansas,2006,M11,4.9,66607,1363500,1296893
Pennsylvania,2002,M03,6.0,370940,6196301,5825361
Kentucky,2008,M01,5.9,118885,2004296,1885411
Kentucky,2001,M11,5.6,108832,1955759,1846927
Louisiana,2003,M10,5.8,117083,2023812,1906729
Virginia,2000,M07,2.4,86739,3636130,3549391
Oregon,2001,M01,6.0,107927,1806545,1698618
Alaska,2005,M07,6.0,21400,355603,334203
Delaware,2004,M03,4.2,17570,419379,401809
Georgia,2013,M01,9.2,439751,4786296,4346545
District of Columbia,2002,M10,6.3,18985,302454,283469
Minnesota,2010,M12,7.0,204298,2926332,2722034
Iowa,2011,M05,5.2,85460,1658970,1573510
Missouri,2012,M03,7.6,230098,3023407,2793309
Washington,2003,M09,6.9,215396,3128659,2913263
District of Columbia,2004,M01,7.2,22042,304492,282450
Kentucky,2009,M01,10.0,203464,2035614,1832150
Arizona,2010,M06,10.5,324108,3096351,2772243
Maryland,2001,M03,3.7,103634,2820231,2716597
Indiana,2016,M09,4.0,134378,3325272,3190894
Minnesota,2003,M09,4.7,136756,2880473,2743717
Indiana,2003,M03,5.5,174809,3168199,2993390
Minnesota,2016,M03,4.6,138515,2997397,2858882
Indiana,2008,M04,4.6,147863,3207357,3059494
Louisiana,2013,M01,7.9,164162,2076259,1912097
Hawaii,2004,M01,3.8,23291,605480,582189
California,2000,M10,4.5,766227,16950544,16184317
Texas,2004,M09,5.7,621936,10978912,10356976
Minnesota,2001,M11,3.8,109344,2854647,2745303
Vermont,2008,M10,4.1,14671,356759,342088
Hawaii,2001,M09,4.4,26660,606469,579809
Pennsylvania,2014,M09,5.1,328446,6379200,6050754
Massachusetts,2003,M05,5.6,190219,3403464,3213245
Texas,2013,M01,6.9,883249,12776939,11893690
Kentucky,2002,M05,5.5,106415,1947356,1840941
Massachusetts,2006,M01,5.5,184743,3366890,3182147
Maryland,2006,M05,3.9,115099,2955534,2840435
Wisconsin,2009,M06,9.0,285084,3158079,2872995
Louisiana,2009,M01,6.7,137386,2057108,1919722
Idaho,2011,M08,7.8,59955,769974,710019
Wyoming,2000,M03,4.4,11666,263855,252189
New Jersey,2013,M02,9.2,420513,4555950,4135437
Georgia,2007,M02,4.3,204377,4767896,4563519
Vermont,2006,M02,4.2,14922,355584,340662
Connecticut,2009,M05,7.6,143787,1889621,1745834
Minnesota,2013,M01,6.3,186715,2947303,2760588
Rhode Island,2005,M05,4.8,26748,559711,532963
Alaska,2008,M05,6.6,23718,357618,333900
Rhode Island,2008,M09,8.0,45341,569632,524291
Idaho,2005,M10,3.1,23186,738012,714826
Nevada,2004,M01,5.1,58943,1159984,1101041
Delaware,2008,M07,4.9,22251,452202,429951
Rhode Island,2006,M07,5.3,30539,579749,549210
New Jersey,2011,M05,9.2,418503,4555198,4136695
Texas,2005,M08,5.4,600394,11141392,10540998
Louisiana,2006,M10,4.0,81550,2014327,1932777
Texas,2002,M07,6.7,725927,10798239,10072312
Ohio,2007,M10,5.2,310101,6002387,5692286
Arkansas,2015,M01,6.3,82313,1302034,1219721
Alabama,2016,M04,5.3,113556,2154477,2040921
Montana,2008,M08,4.7,24551,518553,494002
Missouri,2009,M08,9.7,297961,3059057,2761096
Washington,2000,M05,5.0,151672,3052970,2901298
Minnesota,2008,M07,5.4,160192,2963976,2803784
Kansas,2000,M09,3.6,50323,1391072,1340749
Maryland,2002,M04,4.4,126535,2853443,2726908
Kansas,2005,M03,5.4,78609,1460757,1382148
Missouri,2011,M01,9.8,297278,3034450,2737172
Oregon,2009,M04,12.1,239911,1987509,1747598
Utah,2002,M07,6.1,73274,1194411,1121137
Hawaii,2002,M04,4.3,25556,601094,575538
Utah,2016,M09,3.0,46235,1521521,1475286
Colorado,2012,M10,7.2,201531,2781851,2580320
Tennessee,2015,M10,5.0,154215,3076040,2921825
Wisconsin,2001,M07,4.4,133023,3052936,2919913
Iowa,2009,M01,6.8,113875,1681240,1567365
Illinois,2010,M05,10.1,667477,6631730,5964253
Texas,2012,M01,7.3,911588,12529521,11617933
Delaware,2013,M05,6.6,28966,439413,410447
Michigan,2008,M07,8.9,446669,4997434,4550765
New Jersey,2014,M07,7.2,328770,4587291,4258521
Wyoming,2012,M11,5.2,15895,306948,291053
Louisiana,2004,M05,5.9,119570,2028101,1908531
Tennessee,2004,M10,5.4,156963,2885181,2728218
Vermont,2013,M01,5.3,18478,350718,332240
Texas,2005,M03,5.4,597597,11003333,10405736
District of Columbia,2006,M07,6.1,19814,324628,304814
Pennsylvania,2011,M04,7.3,460029,6342262,5882233
Texas,2008,M01,4.6,527599,11524294,10996695
Illinois,2008,M12,7.6,498047,6586299,6088252
Nevada,2003,M02,5.4,61679,1140536,1078857
Hawaii,2000,M03,4.3,25825,605906,580081
Oregon,2007,M03,5.6,106668,1905494,1798826
Wyoming,2002,M10,3.6,9842,270417,260575
Arkansas,2008,M05,5.1,70673,1381072,1310399
Michigan,2004,M11,6.7,342250,5088529,4746279
Florida,2005,M08,3.7,326715,8820945,8494230
Washington,2001,M07,5.9,179783,3060119,2880336
New York,2001,M08,4.9,450314,9177080,8726766
New Jersey,2016,M11,4.2,186915,4492794,4305879
Mississippi,2000,M12,4.7,62585,1317635,1255050
Nebraska,2012,M03,4.3,43023,1008872,965849
Wyoming,2001,M09,3.3,8914,269463,260549
Ohio,2014,M03,6.5,370271,5665398,5295127
Mississippi,2015,M01,7.4,91668,1243860,1152192
Iowa,2011,M06,5.6,93418,1673408,1579990
Massachusetts,2002,M03,5.3,180637,3408738,3228101
New York,2004,M06,5.8,549936,9429795,8879859
Montana,2012,M10,5.3,26724,507135,480411
Montana,2007,M12,4.2,21304,501862,480558
Maryland,2001,M04,3.5,96988,2808663,2711675
Wisconsin,2016,M10,3.7,114870,3127427,3012557
Tennessee,2005,M01,6.3,180794,2847626,2666832
Mississippi,2010,M09,9.8,131491,1339353,1207862
Michigan,2013,M08,9.0,427883,4767320,4339437
Missouri,2004,M01,5.9,177064,3003570,2826506
Kentucky,2001,M03,5.3,103654,1968947,1865293
South Carolina,2007,M10,5.6,118189,2126290,2008101
Iowa,2002,M04,4.0,65437,1639906,1574469
Alaska,2014,M10,6.2,22382,362629,340247
Mississippi,2003,M01,7.3,93324,1286264,1192940
Connecticut,2007,M08,4.6,86160,1873302,1787142
California,2016,M05,4.9,941445,19021893,18080448
North Carolina,2000,M05,3.5,145443,4136048,3990605
Idaho,2007,M12,3.7,27604,749996,722392
Alabama,2013,M09,7.2,156462,2168032,2011570
Iowa,2015,M05,3.5,60340,1701941,1641601
Oregon,2014,M03,7.7,147564,1912826,1765262
Alaska,2011,M10,7.0,25385,364639,339254
New York,2014,M11,5.8,554485,9560126,9005641
Florida,2000,M01,3.7,288400,7718036,7429636
New Hampshire,2010,M01,7.0,51380,738214,686834
Kansas,2007,M04,3.9,56710,1470705,1413995
Alabama,2011,M01,11.0,243001,2210128,1967127
Pennsylvania,2014,M08,6.1,390239,6430207,6039968
Iowa,2012,M06,5.1,84402,1665798,1581396
New Jersey,2003,M09,5.7,245594,4312879,4067285
Idaho,2001,M07,4.5,30728,689655,658927
Massachusetts,2011,M03,7.7,266040,3456222,3190182
California,2016,M04,5.4,1019131,19030030,18010899
Ohio,2004,M09,5.9,346687,5859046,5512359
Delaware,2004,M08,4.1,17418,423322,405904
New York,2009,M07,8.5,839765,9822015,8982250
Montana,2001,M06,4.5,21230,473899,452669
California,2003,M03,7.1,1220814,17268518,16047704
Arizona,2015,M03,5.9,185229,3137770,2952541
Arizona,2015,M02,6.0,189411,3137774,2948363
Massachusetts,2015,M05,4.9,173700,3568040,3394340
Louisiana,2001,M07,5.7,117422,2057291,1939869
New Hampshire,2004,M12,3.3,23983,716825,692842
Connecticut,2016,M09,4.6,86819,1883920,1797101
Maryland,2010,M05,7.4,227269,3066870,2839601
Maryland,2004,M08,4.2,123334,2913247,2789913
Illinois,2014,M08,6.9,446713,6509893,6063180
Michigan,2007,M06,7.2,366937,5073289,4706352
Missouri,2003,M05,5.6,170381,3032171,2861790
New York,2004,M01,7.1,659999,9263979,8603980
New Jersey,2008,M12,6.6,297197,4523486,4226289
Illinois,2007,M04,4.6,303135,6581374,6278239
Rhode Island,2013,M01,10.5,58327,555731,497404
Maryland,2009,M06,7.3,223227,3062508,2839281
Arkansas,2002,M07,5.8,74860,1293399,1218539
Alaska,2012,M05,7.1,26098,366292,340194
Pennsylvania,2009,M04,7.4,470071,6386248,5916177
Vermont,2002,M12,4.0,13893,344125,330232
North Dakota,2003,M05,3.4,11579,344192,332613
Kansas,2002,M04,4.7,66350,1400683,1334333
Massachusetts,2000,M07,2.8,94849,3361307,3266458
New Jersey,2015,M05,6.1,275748,4550801,4275053
South Carolina,2005,M12,6.7,138832,2068870,1930038
Wisconsin,2003,M02,6.8,207300,3054264,2846964
Virginia,2011,M08,6.9,292077,4232181,3940104
Mississippi,2011,M03,9.8,131410,1339276,1207866
Nebraska,2016,M06,3.5,35621,1023027,987406
Texas,2007,M02,4.5,509904,11341143,10831239
Tennessee,2015,M05,5.8,177969,3086314,2908345
Minnesota,2000,M10,2.7,77844,2831874,2754030
Alaska,2009,M02,8.3,29620,354740,325120
Connecticut,2010,M03,9.2,174380,1886078,1711698
New Mexico,2000,M07,5.2,44514,852189,807675
Texas,2010,M12,7.8,962812,12348803,11385991
Indiana,2003,M10,4.8,154307,3183646,3029339
Minnesota,2016,M10,3.4,103221,3003265,2900044
District of Columbia,2009,M08,9.8,33145,339281,306136
Kentucky,2005,M03,6.2,123360,1982600,1859240
Montana,2000,M07,4.4,20937,476936,455999
Oregon,2010,M05,10.4,205758,1971712,1765954
New Hampshire,2000,M11,2.4,16711,690555,673844
Puerto Rico,2010,M12,14.9,185427,1247189,1061762
Hawaii,2016,M08,2.9,19978,686674,666696
Michigan,2004,M06,7.4,379370,5120115,4740745
Mississippi,2002,M06,7.2,92850,1297374,1204524
New York,2013,M12,6.7,640419,9518410,8877991
New Jersey,2016,M06,5.2,236030,4570417,4334387
New Hampshire,2008,M09,3.6,26468,739364,712896
South Dakota,2001,M01,3.2,12838,401554,388716
Arkansas,2013,M12,6.8,87766,1285768,1198002
Virginia,2003,M06,4.5,171880,3792502,3620622
North Carolina,2011,M08,10.7,495241,4643570,4148329
Wisconsin,2014,M05,5.3,164195,3069533,2905338
North Carolina,2005,M01,5.7,241881,4235552,3993671
Massachusetts,2010,M09,8.0,277923,3462024,3184101
Mississippi,2005,M04,6.1,80537,1315774,1235237
Louisiana,2014,M01,5.8,120784,2076497,1955713
Nevada,2007,M05,4.1,54469,1325032,1270563
South Carolina,2016,M06,5.3,122678,2329058,2206380
South Dakota,2005,M03,4.5,19298,427234,407936
Mississippi,2002,M03,6.8,87147,1284728,1197581
Kentucky,2008,M08,6.6,133942,2036408,1902466
West Virginia,2016,M10,5.3,41772,788123,746351
Idaho,2008,M11,6.5,49074,752995,703921
Indiana,2005,M01,6.2,195090,3152849,2957759
South Carolina,2010,M08,11.2,244749,2179535,1934786
North Carolina,2009,M03,10.5,481683,4566401,4084718
Virginia,2013,M09,5.6,236948,4237241,4000293
Kentucky,2002,M10,5.0,97487,1936428,1838941
Puerto Rico,2015,M05,12.3,136198,1102847,966649
Texas,2006,M12,4.1,466737,11423054,10956317
Georgia,2016,M09,5.5,274962,4957356,4682394
Texas,2016,M07,5.1,674961,13356834,12681873
Connecticut,2009,M10,8.3,157579,1895537,1737958
Arizona,2011,M08,10.1,306952,3037530,2730578
District of Columbia,2008,M09,6.8,22720,331843,309123
Kentucky,2007,M10,4.8,97147,2016431,1919284
Missouri,2008,M03,5.8,174265,3006370,2832105
Utah,2004,M12,4.1,51406,1244296,1192890
Oregon,2015,M04,5.5,107985,1945922,1837937
West Virginia,2010,M08,8.6,69883,814502,744619
Arkansas,2001,M12,5.3,65821,1246914,1181093
Oklahoma,2012,M08,5.2,94416,1801855,1707439
New Jersey,2011,M07,9.7,448175,4619615,4171440
Indiana,2015,M03,5.3,169772,3231083,3061311
Montana,2013,M09,4.5,23084,511394,488310
Texas,2005,M02,5.9,647892,11012340,10364448
Arizona,2000,M07,4.4,109829,2502021,2392192
South Dakota,2009,M09,4.4,19614,441203,421589
Florida,2015,M07,5.8,557088,9651887,9094799
Hawaii,2000,M02,4.4,26821,604299,577478
Florida,2011,M10,9.5,889933,9348735,8458802
Washington,2010,M05,9.9,346766,3517225,3170459
District of Columbia,2007,M10,5.6,18067,324211,306144
Nevada,2016,M07,5.8,83557,1435612,1352055
Pennsylvania,2007,M03,4.4,275314,6280994,6005680
New York,2015,M02,6.2,598407,9590741,8992334
Maryland,2015,M07,5.3,169671,3198909,3029238
Alaska,2002,M08,6.3,21089,332404,311315
Vermont,2015,M09,3.5,12182,344228,332046
Rhode Island,2012,M02,11.8,65900,556871,490971
New Mexico,2004,M12,5.0,45505,914329,868824
Michigan,2008,M05,7.8,384489,4951177,4566688
District of Columbia,2003,M08,7.0,21690,308594,286904
Massachusetts,2011,M10,6.5,225617,3466728,3241111
Delaware,2006,M09,3.4,14988,437518,422530
Ohio,2013,M05,7.2,412555,5738473,5325918
Louisiana,2004,M07,6.4,132249,2078718,1946469
Montana,2001,M03,5.5,25404,464714,439310
Utah,2008,M12,5.1,70535,1376289,1305754
Michigan,2009,M09,13.7,666586,4871227,4204641
Connecticut,2009,M11,8.3,157770,1896550,1738780
Missouri,2006,M09,4.8,144494,3028671,2884177
Indiana,2006,M03,5.4,173921,3216487,3042566
New York,2013,M03,8.0,759977,9556383,8796406
New Mexico,2015,M01,6.6,61236,921689,860453
Utah,2013,M09,4.1,58241,1414729,1356488
Maine,2011,M04,8.5,58623,691930,633307
Maryland,2015,M09,4.8,150627,3140981,2990354
Utah,2008,M05,3.1,42616,1366853,1324237
Pennsylvania,2012,M11,7.1,461881,6461582,5999701
Kentucky,2006,M12,5.0,102097,2044249,1942152
Florida,2001,M09,4.8,390060,8112578,7722518
Iowa,2014,M03,4.9,82944,1697903,1614959
Idaho,2000,M08,4.3,28320,665728,637408
Florida,2012,M03,8.5,787207,9313451,8526244
Kentucky,2001,M06,5.1,101051,1983247,1882196
Oregon,2013,M04,8.0,150549,1891988,1741439
South Carolina,2002,M12,5.9,114920,1945046,1830126
Wisconsin,2009,M08,8.6,269085,3122068,2852983
Maryland,2007,M12,3.1,93096,2967606,2874510
Puerto Rico,2012,M03,15.1,181560,1200633,1019073
District of Columbia,2016,M11,5.7,22343,394454,372111
Maryland,2001,M05,3.6,100830,2820311,2719481
New York,2004,M03,6.7,626040,9280246,8654206
Arkansas,2004,M09,5.2,67698,1304112,1236414
Michigan,2003,M03,7.6,379856,5007093,4627237
Iowa,2006,M08,3.6,59533,1664924,1605391
Arkansas,2001,M05,4.8,60517,1256370,1195853
Florida,2011,M05,9.9,922110,9329251,8407141
Arizona,2003,M04,5.6,152559,2719777,2567218
District of Columbia,2015,M04,6.5,24887,382608,357721
North Dakota,2010,M08,3.5,13466,386041,372575
Michigan,2004,M04,6.4,318453,4987955,4669502
Puerto Rico,2005,M12,10.8,148653,1378789,1230136
Kentucky,2003,M07,6.5,127592,1975529,1847937
Florida,2007,M11,4.4,407341,9200453,8793112
North Dakota,2016,M06,3.5,14765,425186,410421
New Mexico,2012,M02,7.5,69306,926152,856846
California,2007,M01,5.5,976429,17773844,16797415
Iowa,2015,M06,3.9,66743,1718669,1651926
Tennessee,2009,M09,10.4,315062,3027780,2712718
Iowa,2005,M10,3.7,60042,1643913,1583871
Oregon,2008,M02,6.1,116724,1926489,1809765
Mississippi,2003,M11,5.4,70318,1311457,1241139
New Mexico,2015,M05,6.4,58433,920080,861647
Indiana,2007,M09,4.2,133028,3197803,3064775
Montana,2005,M03,5.2,25113,480778,455665
Georgia,2007,M04,4.1,193998,4767022,4573024
New York,2012,M06,8.7,847344,9706110,8858766
Pennsylvania,2000,M05,4.0,244364,6084119,5839755
New Mexico,2015,M12,6.2,57862,926662,868800
Kansas,2015,M10,3.7,54931,1490510,1435579
Tennessee,2009,M07,11.0,340633,3097099,2756466
Michigan,2000,M01,3.8,194160,5129075,4934915
Florida,2002,M08,5.9,484292,8175094,7690802
Louisiana,2007,M05,4.2,85567,2014923,1929356
Wisconsin,2014,M04,5.6,171344,3057426,2886082
Washington,2006,M01,5.6,184272,3278599,3094327
Massachusetts,2000,M05,2.5,81350,3299351,3218001
Vermont,2005,M08,3.2,11227,355420,344193
Hawaii,2001,M05,4.1,24809,610172,585363
Alaska,2012,M10,6.4,23458,364223,340765
Connecticut,2015,M11,5.1,96814,1885957,1789143
Missouri,2000,M08,3.8,110570,2945788,2835218
California,2014,M05,7.2,1342390,18689354,17346964
Alaska,2009,M10,7.6,27366,358511,331145
Ohio,2014,M12,4.9,280747,5676577,5395830
District of Columbia,2009,M04,8.2,26866,328439,301573
Mississippi,2012,M11,8.0,103568,1293435,1189867
Washington,2003,M07,7.3,229202,3146819,2917617
Maine,2013,M11,6.2,43385,703395,660010
Washington,2012,M01,9.4,324812,3454220,3129408
Arizona,2006,M09,4.3,129631,3019029,2889398
Virginia,2010,M04,7.0,290853,4177778,3886925
New York,2003,M06,6.4,601941,9349451,8747510
California,2009,M07,11.7,2142067,18327237,16185170
Illinois,2007,M11,4.8,325048,6726061,6401013
Indiana,2014,M06,5.9,193788,3265099,3071311
Texas,2012,M08,6.9,873812,12643029,11769217
New Hampshire,2011,M10,5.1,37294,734300,697006
New York,2006,M12,4.0,380112,9507821,9127709
New Mexico,2003,M12,5.4,48751,899731,850980
Puerto Rico,2015,M11,11.7,131969,1126837,994868
Michigan,2012,M05,9.1,425751,4690681,4264930
New Jersey,2008,M05,4.9,220774,4487200,4266426
Alabama,2003,M03,5.6,117382,2107136,1989754
Pennsylvania,2001,M10,4.8,295203,6176527,5881324
Georgia,2004,M09,4.8,212619,4450037,4237418
Washington,2008,M11,6.0,209061,3501337,3292276
Pennsylvania,2009,M08,8.4,540110,6437887,5897777
Puerto Rico,2015,M01,10.8,122366,1132263,1009897
South Dakota,2004,M01,4.2,17545,417645,400100
Iowa,2001,M12,3.8,61642,1622007,1560365
West Virginia,2003,M05,6.1,48240,787644,739404
Maine,2011,M08,6.9,49607,716027,666420
North Carolina,2016,M01,5.4,260255,4783164,4522909
Oklahoma,2005,M05,4.6,77431,1698615,1621184
Vermont,2016,M03,3.6,12458,343344,330886
Maryland,2001,M06,4.0,115288,2855867,2740579
Arizona,2010,M03,10.4,322451,3097065,2774614
Ohio,2002,M12,5.6,329678,5837059,5507381
Florida,2004,M05,4.4,373439,8399106,8025667
Louisiana,2013,M03,6.8,141315,2084610,1943295
West Virginia,2004,M06,5.6,44382,795048,750666
Arkansas,2012,M03,7.6,103096,1354687,1251591
Rhode Island,2000,M08,4.2,23297,548740,525443
Indiana,2013,M06,8.1,261554,3235175,2973621
Oklahoma,2002,M06,4.8,81526,1706362,1624836
North Carolina,2008,M08,6.3,288553,4571204,4282651
Connecticut,2014,M03,7.3,136679,1871921,1735242
South Dakota,2003,M02,4.0,16508,415711,399203
Ohio,2014,M07,6.2,356921,5772908,5415987
South Dakota,2004,M10,3.4,14515,429695,415180
Kentucky,2009,M03,10.7,220892,2059824,1838932
Wisconsin,2011,M04,7.9,243285,3062326,2819041
South Dakota,2014,M04,3.6,15988,446023,430035
Massachusetts,2014,M02,6.5,228736,3511050,3282314
Alaska,2008,M12,7.0,24638,353273,328635
Tennessee,2015,M11,4.9,150449,3081393,2930944
Maryland,2005,M05,4.1,120441,2914353,2793912
Vermont,2012,M02,5.5,19515,354374,334859
Georgia,2014,M03,7.3,349480,4760825,4411345
Missouri,2002,M11,5.0,149278,2989225,2839947
Missouri,2000,M05,3.3,98494,2950535,2852041
Georgia,2012,M11,8.4,399922,4785452,4385530
Texas,2013,M11,5.7,732866,12919789,12186923
Florida,2015,M05,5.5,531573,9695580,9164007
Florida,2000,M08,4.2,333654,7922031,7588377
Connecticut,2000,M04,2.3,40795,1756478,1715683
Mississippi,2001,M04,4.6,59823,1293396,1233573
Tennessee,2013,M10,7.6,230851,3044322,2813471
Michigan,2007,M07,8.0,405166,5083120,4677954
Colorado,2001,M01,3.2,76661,2362724,2286063
Mississippi,2014,M03,7.8,97212,1242139,1144927
Maryland,2008,M02,3.5,104639,2951253,2846614
Nevada,2013,M08,9.4,130303,1384472,1254169
West Virginia,2007,M06,4.6,37833,821494,783661
Oklahoma,2001,M06,3.9,65576,1695514,1629938
Kansas,2003,M07,6.2,89992,1461656,1371664
Mississippi,2010,M06,10.6,140280,1318815,1178535
Indiana,2012,M02,9.1,286733,3159829,2873096
Nebraska,2013,M05,3.7,38196,1023139,984943
Maryland,2016,M09,4.2,132464,3177815,3045351
North Carolina,2013,M03,8.3,389249,4666989,4277740
Illinois,2006,M03,4.9,313954,6425780,6111826
Delaware,2013,M08,6.6,29277,444448,415171
Wisconsin,2016,M02,4.9,152272,3106527,2954255
Wyoming,2011,M07,5.1,15966,310751,294785
Illinois,2009,M10,10.6,700108,6585829,5885721
Connecticut,2006,M01,5.0,89114,1799749,1710635
Iowa,2012,M07,5.0,82945,1668976,1586031
Wisconsin,2001,M09,3.9,117056,3003091,2886035
Mississippi,2012,M02,9.3,122702,1324524,1201822
Tennessee,2012,M05,7.7,238977,3106636,2867659
Alabama,2002,M09,5.7,121056,2111500,1990444
Washington,2007,M10,4.2,143585,3437513,3293928
Hawaii,2007,M11,3.1,19711,636703,616992
Ohio,2016,M04,4.8,272309,5706644,5434335
Mississippi,2016,M10,5.7,73056,1287090,1214034
Alaska,2013,M09,6.2,22722,366534,343812
North Dakota,2004,M02,4.3,14809,345543,330734
Alabama,2011,M10,8.9,194917,2200606,2005689
Montana,2014,M08,4.1,21473,522441,500968
New Mexico,2010,M01,8.1,75159,925396,850237
Pennsylvania,2004,M05,5.3,327680,6183016,5855336
South Dakota,2000,M03,2.8,11409,406776,395367
Pennsylvania,2011,M08,8.3,538225,6445944,5907719
Arkansas,2016,M09,3.9,52163,1345513,1293350
District of Columbia,2000,M08,5.7,17766,313160,295394
Maine,2010,M09,7.2,50193,694708,644515
Arizona,2014,M06,7.1,219834,3100928,2881094
Mississippi,2003,M10,5.9,77610,1311749,1234139
Louisiana,2012,M09,6.6,136952,2079782,1942830
Wisconsin,2009,M04,8.7,268303,3099413,2831110
South Dakota,2011,M04,4.9,21558,439232,417674
Connecticut,2015,M09,5.3,99599,1878873,1779274
Colorado,2002,M03,5.8,140883,2421170,2280287
Iowa,2006,M12,3.8,62300,1659056,1596756
West Virginia,2011,M09,7.5,60502,811911,751409
Oklahoma,2013,M09,5.3,95044,1809433,1714389
Idaho,2006,M03,4.6,34151,742533,708382
Kentucky,2008,M09,6.6,133284,2031903,1898619
Wyoming,2008,M01,3.7,10575,287962,277387
Delaware,2002,M12,3.6,14743,413589,398846
Idaho,2013,M06,5.9,46212,781694,735482
Arkansas,2000,M12,4.1,51272,1239963,1188691
New Mexico,2002,M05,5.4,46941,868553,821612
Idaho,2007,M08,2.6,19834,761157,741323
Vermont,2014,M04,4.2,14337,344258,329921
Oregon,2015,M09,5.1,101570,1999815,1898245
Indiana,2002,M02,5.9,185568,3149772,2964204
Alaska,2007,M03,7.1,24449,346333,321884
Nebraska,2004,M09,3.7,35386,964199,928813
Arizona,2009,M06,10.1,318563,3144544,2825981
Wyoming,2002,M01,4.8,12795,265552,252757
Nevada,2006,M09,4.0,52085,1299453,1247368
South Carolina,2006,M03,6.2,128852,2085474,1956622
Minnesota,2006,M07,3.7,108490,2913943,2805453
Hawaii,2001,M01,4.1,24999,608789,583790
Illinois,2007,M12,5.4,364797,6716593,6351796
Iowa,2010,M03,6.9,115278,1677566,1562288
Virginia,2012,M10,5.6,238911,4238102,3999191
Mississippi,2002,M02,6.9,88409,1286281,1197872
Nevada,2005,M12,3.7,46459,1243843,1197384
Vermont,2010,M06,6.1,22300,363438,341138
Iowa,2010,M12,5.9,98837,1673925,1575088
Florida,2008,M03,5.0,454615,9163443,8708828
Mississippi,2015,M12,6.5,84622,1292201,1207579
New Mexico,2014,M01,7.1,65239,919078,853839
Oregon,2008,M08,6.5,128972,1979227,1850255
Tennessee,2008,M04,5.3,161447,3032249,2870802
Ohio,2013,M01,8.9,502898,5668575,5165677
Maryland,2006,M10,3.6,108624,2977277,2868653
Washington,2008,M12,6.6,231396,3501430,3270034
Wisconsin,2013,M10,5.9,180738,3071460,2890722
Montana,2012,M12,5.8,29178,503494,474316
New York,2000,M03,5.0,459536,9137967,8678431
Michigan,2015,M03,5.9,277671,4726538,4448867
New Hampshire,2007,M09,3.1,22983,734352,711369
Virginia,2007,M11,3.0,120491,4065754,3945263
Oregon,2004,M08,7.1,131012,1856692,1725680
Alaska,2012,M03,8.0,28912,362360,333448
Utah,2009,M04,7.0,95275,1362356,1267081
Arizona,2007,M04,3.5,104770,3008613,2903843
District of Columbia,2011,M04,9.6,33547,348778,315231
California,2000,M02,5.4,900935,16758803,15857868
New Mexico,2016,M10,6.6,61112,929347,868235
South Dakota,2006,M07,3.0,13140,445355,432215
Delaware,2007,M04,3.4,15125,442114,426989
Arkansas,2004,M11,5.0,65505,1312272,1246767
North Carolina,2013,M04,7.8,365892,4674931,4309039
New Jersey,2011,M03,9.7,440651,4554081,4113430
Ohio,2007,M01,6.2,369465,5937069,5567604
Illinois,2016,M12,5.6,363140,6481471,6118331
Pennsylvania,2015,M08,5.4,350589,6459149,6108560
New Mexico,2005,M07,5.6,51726,926844,875118
Iowa,2003,M03,5.0,80464,1611336,1530872
Vermont,2014,M12,3.5,12071,345235,333164
Nevada,2009,M12,12.5,168039,1341802,1173763
Illinois,2001,M06,5.4,351886,6535984,6184098
Michigan,2010,M12,10.9,510025,4690696,4180671
Connecticut,2016,M01,6.1,114735,1880245,1765510
Minnesota,2005,M04,4.2,120241,2871787,2751546
Hawaii,2002,M08,3.9,23362,599378,576016
South Carolina,2007,M11,5.4,114045,2117305,2003260
Illinois,2004,M08,6.1,385840,6349595,5963755
North Dakota,2011,M09,2.9,11166,391372,380206
Indiana,2014,M04,5.5,177333,3205077,3027744
Florida,2001,M08,5.0,400104,8057043,7656939
West Virginia,2002,M04,6.1,49200,802148,752948
Iowa,2001,M08,3.1,49893,1610068,1560175
Oklahoma,2004,M04,4.6,76731,1679567,1602836
Montana,2009,M03,7.9,39333,498800,459467
New Jersey,2005,M10,4.3,188110,4413259,4225149
North Dakota,2016,M01,3.9,16099,408127,392028
Utah,2015,M02,4.0,58285,1448197,1389912
Montana,2016,M08,3.7,19672,534042,514370
Utah,2013,M11,3.7,52585,1421235,1368650
Tennessee,2001,M08,4.8,137574,2843586,2706012
Oregon,2016,M10,4.5,94169,2076489,1982320
Washington,2012,M09,7.3,253201,3465887,3212686
Iowa,2004,M10,4.1,65883,1609657,1543774
Florida,2010,M07,11.4,1061374,9290269,8228895
South Dakota,2010,M02,5.9,25582,436644,411062
South Dakota,2001,M11,3.1,12840,413676,400836
Nevada,2007,M03,4.3,56331,1320196,1263865
Washington,2009,M05,8.7,308090,3524785,3216695
Michigan,2009,M08,14.1,697456,4944015,4246559
Indiana,2014,M05,5.9,190807,3241059,3050252
West Virginia,2003,M07,6.1,48480,794269,745789
Kentucky,2015,M02,5.9,114655,1957370,1842715
Oklahoma,2005,M07,4.5,77389,1718258,1640869
Tennessee,2006,M04,5.2,155919,2992939,2837020
Florida,2015,M04,5.2,502591,9598700,9096109
South Carolina,2001,M05,4.7,91219,1955003,1863784
Kansas,2013,M10,4.8,70916,1484759,1413843
Pennsylvania,2013,M09,6.8,437360,6430850,5993490
District of Columbia,2005,M04,6.2,19497,313856,294359
Delaware,2009,M09,8.4,36109,428176,392067
Utah,2012,M11,4.5,62257,1386151,1323894
Ohio,2014,M05,5.5,312299,5695348,5383049
New Hampshire,2012,M12,5.3,39476,739568,700092
Mississippi,2010,M01,11.7,147665,1257140,1109475
Pennsylvania,2010,M08,8.5,545343,6444373,5899030
Colorado,2011,M11,8.0,220558,2753005,2532447
New York,2001,M09,5.0,456566,9129382,8672816
Iowa,2008,M06,4.0,68279,1691870,1623591
Missouri,2009,M09,9.4,286605,3039869,2753264
Alabama,2012,M01,8.3,177986,2151638,1973652
District of Columbia,2008,M07,6.6,22231,339374,317143
Tennessee,2000,M01,4.3,122637,2841756,2719119
Hawaii,2004,M12,2.8,16989,616033,599044
Indiana,2009,M04,9.9,316230,3205147,2888917
North Dakota,2008,M12,3.5,12732,364233,351501
South Dakota,2010,M11,4.6,20369,440475,420106
West Virginia,2000,M08,5.2,42017,808562,766545
Oklahoma,2006,M08,3.9,67596,1719589,1651993
Virginia,2016,M04,3.6,152750,4226469,4073719
Delaware,2013,M12,5.7,25293,444792,419499
South Dakota,2006,M11,2.9,12880,437922,425042
Puerto Rico,2001,M08,12.8,163167,1270194,1107027
Iowa,2015,M07,3.7,63490,1721023,1657533
Maryland,2002,M07,4.5,130255,2911311,2781056
Alabama,2013,M01,8.2,177887,2166067,1988180
New York,2011,M06,8.2,782485,9542714,8760229
Puerto Rico,2009,M10,16.2,210305,1300487,1090182
Delaware,2013,M01,7.8,34474,441773,407299
Missouri,2011,M07,8.6,262232,3066302,2804070
Maryland,2000,M08,3.8,106976,2814740,2707764
Rhode Island,2011,M09,10.6,59317,558452,499135
Virginia,2006,M02,3.4,133481,3919230,3785749
Nevada,2013,M02,10.3,142763,1381927,1239164
New Hampshire,2009,M10,5.8,43027,738189,695162
Rhode Island,2006,M04,4.8,27485,567993,540508
Pennsylvania,2003,M10,5.1,313591,6161011,5847420
Kansas,2003,M09,5.5,79494,1433979,1354485
Vermont,2014,M03,4.4,15342,347785,332443
Pennsylvania,2013,M04,7.0,448643,6414127,5965484
Iowa,2016,M02,4.3,73843,1700054,1626211
Idaho,2012,M12,6.8,52088,766333,714245
Iowa,2012,M05,4.7,76910,1649000,1572090
North Dakota,2002,M04,4.0,13641,339338,325697
Virginia,2015,M08,4.4,183615,4201876,4018261
Wisconsin,2015,M04,4.5,137201,3068174,2930973
Utah,2013,M07,4.8,68065,1422826,1354761
Georgia,2003,M07,5.4,236471,4416018,4179547
New Mexico,2003,M03,5.8,50597,878746,828149
Iowa,2006,M11,3.4,56052,1667432,1611380
New York,2005,M12,4.7,444914,9472981,9028067
Virginia,2012,M11,5.4,228728,4209305,3980577
Delaware,2010,M05,8.1,34923,431888,396965
Maryland,2007,M04,3.2,93529,2939768,2846239
Arizona,2004,M02,5.1,139986,2768970,2628984
Oregon,2002,M02,8.7,159183,1825206,1666023
Delaware,2012,M10,7.1,31572,444538,412966
Rhode Island,2005,M06,4.9,27651,569112,541461
North Dakota,2003,M07,3.5,12169,352533,340364
Utah,2007,M01,2.7,36529,1338908,1302379
New Jersey,2016,M01,5.2,232767,4485206,4252439
Indiana,2011,M04,8.4,264539,3156572,2892033
Illinois,2002,M03,6.7,429809,6374030,5944221
Missouri,2014,M12,5.0,154159,3057647,2903488
Puerto Rico,2005,M09,10.6,149934,1407844,1257910
Wisconsin,2005,M02,5.9,175993,3002066,2826073
Ohio,2003,M04,6.2,365226,5868736,5503510
North Carolina,2015,M08,6.0,284530,4755996,4471466
Wyoming,2006,M09,2.8,7878,282373,274495
Texas,2014,M12,4.2,541484,12951573,12410089
Ohio,2012,M08,7.2,413385,5729353,5315968
South Carolina,2009,M01,10.6,226448,2145428,1918980
Hawaii,2007,M04,2.5,15941,640381,624440
New Mexico,2015,M09,6.4,58628,918593,859965
Utah,2013,M01,5.5,76236,1389176,1312940
Nevada,2001,M07,5.0,56475,1119766,1063291
Virginia,2004,M02,4.2,156764,3760286,3603522
New Mexico,2010,M03,8.2,75949,929659,853710
Minnesota,2010,M02,8.4,245908,2912617,2666709
North Dakota,2000,M08,2.8,9876,350401,340525
Hawaii,2014,M02,4.6,30386,660232,629846
South Carolina,2014,M10,6.6,148398,2251292,2102894
Minnesota,2015,M11,3.1,93440,2972309,2878869
Rhode Island,2002,M06,4.8,26500,552535,526035
Ohio,2000,M08,4.0,235871,5831046,5595175
Rhode Island,2010,M03,11.7,65807,562588,496781
Utah,2010,M11,7.1,96706,1354030,1257324
Vermont,2016,M05,3.0,10313,342550,332237
Utah,2006,M05,3.0,39510,1309733,1270223
Montana,2012,M01,7.4,36699,498286,461587
Florida,2007,M02,3.4,309536,9077421,8767885
Washington,2005,M10,4.9,162599,3297378,3134779
Puerto Rico,2013,M07,14.7,171505,1169136,997631
Wisconsin,2013,M04,7.1,217044,3068832,2851788
Illinois,2005,M04,5.7,362833,6351449,5988616
South Dakota,2015,M04,3.2,14168,449437,435269
Idaho,2011,M04,8.8,66845,760627,693782
Maryland,2013,M07,6.8,215725,3178857,2963132
Puerto Rico,2014,M10,13.7,154479,1126258,971779
Illinois,2012,M09,8.3,548420,6576909,6028489
Alabama,2009,M10,11.7,252694,2158726,1906032
Ohio,2003,M09,5.8,339401,5843663,5504262
Minnesota,2006,M09,3.7,107709,2887503,2779794
Hawaii,2012,M12,4.8,30993,644185,613192
Nevada,2005,M01,4.6,55284,1195000,1139716
Minnesota,2014,M11,3.3,98902,2961227,2862325
Arkansas,2012,M02,8.3,111855,1351746,1239891
Arizona,2006,M06,4.5,134598,2992475,2857877
Michigan,2015,M07,6.3,304750,4808215,4503465
Virginia,2007,M01,3.3,131632,3990065,3858433
Indiana,2011,M12,8.7,277085,3179136,2902051
New York,2010,M07,8.6,839019,9721397,8882378
Kansas,2000,M04,3.2,45433,1410979,1365546
Florida,2016,M12,4.7,467212,9909607,9442395
New Hampshire,2003,M12,3.9,27267,707733,680466
Texas,2001,M09,5.3,560366,10557421,9997055
Ohio,2010,M01,12.0,697677,5817908,5120231
Wisconsin,2003,M03,6.7,204177,3048540,2844363
Wisconsin,2013,M05,6.5,199876,3073725,2873849
Vermont,2007,M07,3.8,13696,358428,344732
Vermont,2013,M10,3.6,12613,350072,337459
Hawaii,2004,M09,3.4,20955,608528,587573
Wyoming,2009,M07,6.3,19226,304603,285377
Arkansas,2005,M10,4.5,60629,1358756,1298127
Indiana,2013,M07,7.7,247873,3223235,2975362
Vermont,2005,M12,3.2,11503,354899,343396
Idaho,2005,M06,3.7,27587,740691,713104
Nevada,2014,M12,7.2,100685,1398606,1297921
North Carolina,2001,M08,5.8,243505,4179425,3935920
California,2009,M04,10.4,1900577,18201524,16300947
South Carolina,2002,M03,5.7,110090,1928445,1818355
North Dakota,2004,M11,3.0,10386,350327,339941
Maine,2004,M03,5.4,36584,674917,638333
Idaho,2008,M08,5.2,39995,764930,724935
West Virginia,2002,M10,5.2,41719,799596,757877
South Carolina,2004,M08,6.9,142607,2054914,1912307
Oklahoma,2004,M10,4.7,79069,1699867,1620798
Montana,2013,M12,5.4,27348,509189,481841
New York,2015,M05,5.3,511162,9639573,9128411
New York,2007,M10,4.4,422315,9525239,9102924
Arizona,2001,M06,5.0,128020,2581539,2453519
Maine,2002,M07,4.1,28387,694056,665669
Wyoming,2002,M11,4.2,11465,270990,259525
Tennessee,2014,M07,7.3,226133,3082201,2856068
Idaho,2014,M07,4.6,36528,793232,756704
Michigan,2004,M10,6.5,327611,5075141,4747530
Oklahoma,2016,M07,5.1,93412,1831221,1737809
Idaho,2012,M09,6.3,48562,768956,720394
New York,2013,M04,7.4,704852,9572388,8867536
South Carolina,2005,M10,6.9,144029,2090330,1946301
Pennsylvania,2005,M07,5.1,324832,6359412,6034580
Montana,2001,M05,4.1,18990,467422,448432
Virginia,2010,M10,6.6,275847,4162485,3886638
Alaska,2008,M03,7.3,25771,351093,325322
District of Columbia,2001,M03,6.1,18943,309053,290110
West Virginia,2006,M08,5.3,43171,812862,769691
Oklahoma,2000,M08,3.0,49899,1658971,1609072
Montana,2009,M01,7.7,38574,500439,461865
Utah,2008,M07,3.7,50792,1382958,1332166
Vermont,2015,M12,3.0,10341,342701,332360
New Jersey,2007,M03,4.4,193844,4421666,4227822
Ohio,2011,M01,10.2,581995,5731591,5149596
New Jersey,2007,M12,4.3,191870,4468882,4277012
Wisconsin,2015,M10,3.9,120180,3100845,2980665
Connecticut,2011,M12,7.7,146465,1893678,1747213
Idaho,2000,M01,6.0,38676,648832,610156
Hawaii,2014,M10,4.1,27404,665624,638220
South Carolina,2014,M02,6.4,138854,2175846,2036992
District of Columbia,2016,M12,5.5,21456,392765,371309
Missouri,2010,M08,9.7,297072,3063718,2766646
Nevada,2000,M10,4.2,45821,1083847,1038026
Louisiana,2013,M05,6.9,146049,2108651,1962602
Massachusetts,2006,M10,4.3,146131,3424841,3278710
Massachusetts,2013,M09,6.6,231832,3500345,3268513
Louisiana,2009,M10,7.0,145588,2068010,1922422
Utah,2016,M08,3.4,51814,1521514,1469700
Ohio,2002,M03,6.2,361661,5834446,5472785
New Hampshire,2004,M10,3.2,22805,716766,693961
California,2016,M11,5.0,963869,19157621,18193752
Illinois,2005,M10,5.1,325409,6431182,6105773
North Carolina,2000,M11,3.9,163766,4154893,3991127
Kentucky,2009,M05,10.6,220286,2075310,1855024
New Jersey,2015,M06,6.0,273636,4579354,4305718
Hawaii,2011,M06,7.4,49021,666121,617100
West Virginia,2014,M04,6.6,52312,792725,740413
Oklahoma,2008,M04,2.9,50232,1729898,1679666
Texas,2010,M06,8.4,1029896,12268417,11238521
Massachusetts,2005,M08,4.5,152653,3428999,3276346
Washington,2015,M12,5.8,208260,3575366,3367106
Indiana,2009,M05,10.4,335850,3225042,2889192
California,2011,M04,11.5,2108789,18313681,16204892
Arkansas,2001,M07,5.4,68376,1275987,1207611
Alaska,2002,M09,6.6,21782,328111,306329
Washington,2014,M10,5.6,197952,3522841,3324889
Maine,2001,M12,4.0,26762,668546,641784
District of Columbia,2011,M09,10.4,36263,350289,314026
New Jersey,2012,M03,9.5,432931,4574565,4141634
Massachusetts,2003,M01,6.3,214157,3413312,3199155
Nevada,2003,M03,5.3,60207,1138842,1078635
Mississippi,2015,M09,6.0,76338,1274232,1197894
South Dakota,2014,M09,2.9,13093,446517,433424
Ohio,2011,M03,9.2,529999,5747803,5217804
West Virginia,2003,M11,5.1,39600,781393,741793
Indiana,2014,M12,5.5,177591,3231197,3053606
Oklahoma,2005,M11,4.0,68088,1717586,1649498
Washington,2008,M02,5.5,188269,3446201,3257932
Wisconsin,2002,M05,5.0,151331,3001367,2850036
North Carolina,2012,M09,8.7,407653,4704323,4296670
Massachusetts,2007,M03,4.8,163072,3406868,3243796
Idaho,2012,M08,6.7,52019,772700,720681
Puerto Rico,2004,M01,11.3,150669,1332886,1182217
California,2004,M09,5.6,980739,17368856,16388117
Florida,2016,M03,4.8,466631,9790964,9324333
North Carolina,2014,M08,6.8,317314,4682170,4364856
Pennsylvania,2014,M11,4.9,314365,6391520,6077155
New Mexico,2007,M07,4.2,39920,941669,901749
New Hampshire,2011,M12,5.2,38089,735110,697021
New Mexico,2003,M10,5.6,50493,897662,847169
Maine,2005,M11,4.6,32113,697745,665632
Alabama,2016,M09,6.2,134032,2176728,2042696
Vermont,2009,M08,6.2,22367,362595,340228
Alaska,2011,M06,7.6,28269,372776,344507
Michigan,2002,M08,5.8,292442,5025223,4732781
Illinois,2015,M11,5.8,379392,6533797,6154405
New York,2013,M10,7.4,711607,9575769,8864162
Michigan,2015,M01,6.6,311556,4723363,4411807
Idaho,2010,M10,8.1,61375,760945,699570
Nevada,2010,M08,13.5,184021,1361085,1177064
New Jersey,2006,M09,4.5,197892,4418140,4220248
North Dakota,2006,M08,2.9,10848,368178,357330
California,2008,M04,6.1,1103750,18040707,16936957
Michigan,2010,M09,11.5,546577,4762978,4216401
Colorado,2016,M10,2.8,82055,2915022,2832967
Arizona,2002,M04,5.9,157205,2658082,2500877
Wisconsin,2009,M05,8.5,263960,3099673,2835713
Nevada,2009,M09,12.0,160837,1344354,1183517
Washington,2000,M11,5.2,158871,3037242,2878371
Louisiana,2007,M07,4.7,96975,2065429,1968454
Wyoming,2016,M07,5.0,15458,306926,291468
West Virginia,2016,M12,5.1,39261,771785,732524
Michigan,2003,M01,7.3,364161,4969941,4605780
Virginia,2005,M07,3.6,144050,3966389,3822339
Vermont,2001,M06,3.3,11156,340889,329733
Colorado,2011,M09,7.9,218432,2757366,2538934
California,2014,M03,8.3,1552238,18746596,17194358
Delaware,2010,M11,7.7,33636,437613,403977
Alaska,2008,M06,6.7,24546,364161,339615
Florida,2002,M09,5.6,456576,8219085,7762509
Florida,2005,M11,3.5,311487,8824572,8513085
West Virginia,2011,M07,7.7,62301,808138,745837
Nebraska,2007,M05,3.0,29252,981634,952382
Illinois,2011,M11,9.0,594732,6586353,5991621
Maryland,2011,M08,7.4,231577,3117540,2885963
Oklahoma,2013,M07,5.3,97002,1817217,1720215
Illinois,2008,M11,6.6,432000,6580981,6148981
Puerto Rico,2002,M07,12.9,169539,1316935,1147396
Kansas,2016,M01,4.3,63725,1483297,1419572
Wyoming,2005,M11,3.5,9682,277940,268258
Maine,2010,M04,8.5,58676,688846,630170
Idaho,2007,M02,4.2,31541,748736,717195
Michigan,2006,M02,7.5,380125,5059062,4678937
North Dakota,2014,M04,2.8,11390,411200,399810
Iowa,2008,M08,4.2,70102,1681321,1611219
Mississippi,2000,M05,5.6,74563,1327070,1252507
Missouri,2003,M03,5.7,171989,3010808,2838819
Tennessee,2013,M04,7.6,233201,3077745,2844544
Nebraska,2004,M07,4.0,39218,986901,947683
Puerto Rico,2016,M09,13.1,146222,1119147,972925
Maine,2015,M02,5.7,38810,675176,636366
Maryland,2010,M03,8.1,246268,3049477,2803209
Washington,2014,M02,7.2,248773,3467694,3218921
Oregon,2015,M07,5.9,118212,1999947,1881735
Washington,2012,M11,7.3,250641,3452360,3201719
Arizona,2003,M07,6.1,168224,2736284,2568060
Georgia,2004,M11,5.0,223567,4507637,4284070
New Hampshire,2003,M11,4.0,28532,709922,681390
Illinois,2010,M06,10.4,698892,6702344,6003452
Arizona,2015,M12,5.4,172789,3192695,3019906
New Hampshire,2004,M02,4.7,33047,707865,674818
Maine,2004,M01,5.6,37621,674465,636844
Indiana,2008,M07,6.1,200016,3283458,3083442
Kansas,2001,M07,4.4,62436,1408542,1346106
Illinois,2005,M05,5.6,357317,6370998,6013681
Kentucky,2013,M12,7.1,144703,2029059,1884356
South Dakota,2010,M06,4.7,21211,449100,427889
Connecticut,2008,M07,6.0,115125,1916095,1800970
Iowa,2008,M11,4.4,73964,1685493,1611529
West Virginia,2013,M02,8.1,64973,797561,732588
Oklahoma,2011,M02,6.4,111748,1748635,1636887
Washington,2007,M12,4.8,165150,3439909,3274759
Michigan,2015,M05,5.8,280457,4803571,4523114
Tennessee,2006,M09,4.9,149297,3053267,2903970
Indiana,2012,M12,8.5,269186,3165048,2895862
Utah,2001,M01,4.1,47032,1154085,1107053
Colorado,2016,M05,3.3,93353,2871881,2778528
West Virginia,2003,M06,6.5,52282,799103,746821
Oklahoma,2005,M06,5.0,86696,1725155,1638459
New Mexico,2006,M03,4.1,37993,918524,880531
Colorado,2004,M01,6.3,158242,2500641,2342399
Delaware,2009,M08,8.4,36758,436977,400219
Maine,2016,M11,3.7,25518,691090,665572
District of Columbia,2001,M01,6.4,19883,310394,290511
Indiana,2000,M09,2.3,71797,3092903,3021106
Rhode Island,2014,M03,9.0,49670,552175,502505
Indiana,2013,M05,7.8,248480,3199396,2950916
Virginia,2008,M09,4.0,166003,4139951,3973948
New Hampshire,2007,M11,3.2,23271,736747,713476
New Hampshire,2004,M11,3.4,24098,717620,693522
California,2016,M10,5.2,1007701,19201496,18193795
Alaska,2010,M11,7.7,27892,360864,332972
Alaska,2011,M05,7.4,27203,365295,338092
Michigan,2013,M10,8.4,395287,4716639,4321352
Georgia,2011,M07,10.7,509050,4765652,4256602
Rhode Island,2010,M06,10.9,62000,569685,507685
Alabama,2006,M02,4.5,96643,2150366,2053723
Georgia,2002,M04,4.9,212511,4297814,4085303
South Carolina,2002,M01,6.3,121011,1910572,1789561
Ohio,2002,M02,6.2,362369,5824355,5461986
Idaho,2005,M05,3.7,26662,729604,702942
District of Columbia,2005,M07,6.3,20295,323030,302735
North Dakota,2011,M07,3.3,13124,396978,383854
Maine,2007,M02,5.4,37338,693124,655786
Montana,2008,M09,4.7,24189,509346,485157
Vermont,2002,M11,4.1,13994,343718,329724
Illinois,2008,M02,5.9,394039,6653937,6259898
Rhode Island,2007,M03,5.2,29854,569443,539589
Washington,2012,M07,8.2,286256,3497982,3211726
New Hampshire,2002,M02,4.9,34380,695899,661519
Washington,2016,M06,5.4,196498,3655602,3459104
Indiana,2010,M03,11.6,367860,3162721,2794861
North Dakota,2000,M06,3.3,11478,351725,340247
Colorado,2010,M04,8.5,232113,2720768,2488655
New York,2006,M02,5.3,506410,9474990,8968580
West Virginia,2015,M02,7.9,61469,778066,716597
Oklahoma,2009,M02,5.8,100938,1745602,1644664
Washington,2015,M11,5.6,200738,3563922,3363184
Vermont,2010,M09,5.6,19991,357720,337729
Hawaii,2012,M04,6.2,40409,649170,608761
Pennsylvania,2004,M03,6.0,367543,6164709,5797166
Nevada,2011,M08,13.1,179743,1376209,1196466
Illinois,2015,M12,6.0,390322,6533874,6143552
Kansas,2016,M09,4.1,60371,1478192,1417821
Nevada,2000,M05,3.8,39690,1057926,1018236
Virginia,2008,M07,4.1,170943,4201854,4030911
Iowa,2002,M12,4.2,67227,1619440,1552213
Georgia,2003,M06,5.7,254276,4422977,4168701
Utah,2001,M05,4.1,47618,1158632,1111014
Mississippi,2007,M12,6.1,81587,1330529,1248942
Colorado,2016,M01,3.8,108016,2848862,2740846
West Virginia,2000,M05,5.4,43708,810825,767117
Oklahoma,2006,M05,4.0,69087,1710675,1641588
Utah,2000,M09,3.2,37176,1147983,1110807
District of Columbia,2002,M05,6.1,18671,304551,285880
Kentucky,2007,M01,6.3,128240,2027777,1899537
Rhode Island,2008,M12,9.2,52740,570336,517596
Washington,2000,M12,5.3,160303,3043707,2883404
Connecticut,2014,M04,6.4,119932,1863974,1744042
Indiana,2001,M03,4.2,133077,3143874,3010797
West Virginia,2016,M11,5.0,38750,779129,740379
South Dakota,2013,M10,3.3,14585,446098,431513
California,2006,M07,5.2,929434,17741764,16812330
Louisiana,2011,M01,8.8,181406,2053063,1871657
New Mexico,2006,M11,3.7,34822,936717,901895
Montana,2005,M01,5.7,27410,476842,449432
Wisconsin,2000,M01,3.8,111587,2937279,2825692
Nebraska,2012,M04,3.9,39446,1012752,973306
Texas,2016,M11,4.5,599870,13371089,12771219
Washington,2011,M11,8.7,299338,3451815,3152477
Wisconsin,2002,M11,4.9,147634,3027370,2879736
Massachusetts,2004,M01,6.2,211935,3401525,3189590
Washington,2007,M02,5.5,183518,3361110,3177592
Georgia,2011,M11,9.5,453416,4780553,4327137
New Mexico,2005,M01,5.7,51496,905560,854064
North Carolina,2003,M05,6.4,271603,4274545,4002942
Nevada,2001,M12,6.1,68379,1121315,1052936
Iowa,2014,M02,5.1,86877,1692957,1606080
Arkansas,2015,M08,4.7,63471,1338148,1274677
Hawaii,2008,M02,3.1,19874,638269,618395
Illinois,2014,M02,8.9,581333,6517986,5936653
Arkansas,2009,M09,7.6,102138,1351223,1249085
Wisconsin,2010,M01,10.1,310724,3061794,2751070
Wisconsin,2010,M08,8.2,253443,3102723,2849280
Alabama,2014,M06,7.4,161135,2181034,2019899
Puerto Rico,2011,M03,17.1,210441,1230197,1019756
North Carolina,2004,M07,5.6,240323,4301111,4060788
Montana,2010,M12,7.6,37457,495195,457738
New Hampshire,2000,M05,2.5,17187,683286,666099
New York,2007,M02,4.9,460426,9475857,9015431
Delaware,2012,M02,7.6,33736,443583,409847
Mississippi,2007,M07,6.7,88155,1317760,1229605
Nevada,2002,M10,5.1,57423,1134838,1077415
Massachusetts,2004,M10,4.4,148197,3375729,3227532
New York,2004,M05,5.6,518046,9271495,8753449
New Hampshire,2002,M10,4.2,29619,702019,672400
Illinois,2000,M08,4.5,290441,6500155,6209714
Arkansas,2013,M01,8.4,108803,1297279,1188476
Wisconsin,2006,M09,4.1,126491,3059687,2933196
New Jersey,2007,M06,4.2,190224,4479757,4289533
Hawaii,2003,M06,5.0,30107,607839,577732
New Jersey,2009,M04,8.5,385687,4547009,4161322
Michigan,2001,M08,5.1,258346,5107267,4848921
Minnesota,2005,M10,3.4,97670,2891688,2794018
Alaska,2007,M12,6.5,22816,348689,325873
Oklahoma,2016,M06,5.4,99152,1839619,1740467
Montana,2004,M10,4.2,20046,479997,459951
Ohio,2007,M03,5.5,328319,5949854,5621535
Wyoming,2016,M09,4.5,13574,301548,287974
Illinois,2003,M09,6.6,415932,6280939,5865007
Mississippi,2004,M04,5.1,66775,1303077,1236302
Nevada,2011,M04,13.2,181060,1370856,1189796
Maine,2009,M09,7.4,51235,693636,642401
Montana,2009,M10,6.2,30939,496681,465742
Louisiana,2015,M09,6.1,131565,2142859,2011294
Alabama,2016,M11,5.7,123834,2184641,2060807
South Carolina,2008,M10,7.8,167350,2155357,1988007
North Dakota,2000,M05,2.5,8638,343410,334772
Puerto Rico,2013,M11,14.1,164170,1168211,1004041
Colorado,2003,M11,5.8,145302,2504868,2359566
Alaska,2015,M06,6.5,24194,370528,346334
Connecticut,2000,M09,1.8,32117,1750085,1717968
West Virginia,2008,M09,3.6,29651,815060,785409
Oklahoma,2014,M09,4.2,75493,1796102,1720609
Kentucky,2011,M09,9.1,188024,2058039,1870015
North Dakota,2000,M12,2.9,9830,338749,328919
Idaho,2009,M05,8.7,66444,759550,693106
New Jersey,2004,M06,5.0,218796,4391622,4172826
Florida,2007,M10,4.4,404959,9179249,8774290
Washington,2005,M02,6.6,212744,3229435,3016691
Hawaii,2004,M06,3.9,23884,614152,590268
Maryland,2014,M01,6.3,195999,3093663,2897664
Kentucky,2013,M11,7.3,148716,2040259,1891543
Idaho,2011,M12,7.9,60763,766511,705748
Illinois,2003,M07,7.1,452261,6370641,5918380
Delaware,2005,M12,3.8,16834,441083,424249
Maryland,2012,M07,7.3,231117,3169817,2938700
South Dakota,2014,M11,3.3,14729,449145,434416
Hawaii,2010,M02,6.9,43761,632922,589161
Washington,2009,M07,9.2,330670,3581844,3251174
Idaho,2014,M06,4.6,36283,791232,754949
Oregon,2012,M09,8.0,154880,1944712,1789832
Maryland,2008,M08,4.6,138472,3030404,2891932
Pennsylvania,2003,M11,5.2,321671,6176796,5855125
Massachusetts,2000,M03,3.1,102231,3322457,3220226
New Hampshire,2011,M02,5.9,43537,732764,689227
Nebraska,2011,M09,4.1,40853,997971,957118
West Virginia,2012,M08,7.6,61697,810068,748371
Oklahoma,2010,M08,6.6,117304,1771356,1654052
Arizona,2003,M09,5.9,161000,2751628,2590628
Louisiana,2006,M04,4.1,79737,1967932,1888195
Virginia,2005,M11,3.3,127730,3915356,3787626
Michigan,2014,M01,8.4,392183,4691659,4299476
Arizona,2006,M03,4.2,124208,2951138,2826930
South Dakota,2016,M05,2.6,11951,453250,441299
California,2010,M03,12.6,2312390,18283045,15970655
Illinois,2013,M03,9.2,599691,6507981,5908290
Maine,2005,M10,4.3,30448,704888,674440
Alaska,2012,M06,7.2,26794,372708,345914
New York,2000,M10,4.2,380430,9103896,8723466
Puerto Rico,2007,M02,10.9,158104,1449619,1291515
Idaho,2003,M09,4.7,32153,686648,654495
Hawaii,2012,M08,5.7,36604,645292,608688
Tennessee,2013,M11,6.8,207287,3037671,2830384
Nevada,2004,M05,4.1,47722,1170002,1122280
Georgia,2001,M09,4.2,178241,4251306,4073065
Missouri,2009,M12,9.4,283720,3008328,2724608
Vermont,2009,M06,6.9,25144,365033,339889
Michigan,2016,M02,5.1,242852,4794016,4551164
Iowa,2012,M01,6.1,100272,1644926,1544654
North Carolina,2013,M12,6.6,303346,4623578,4320232
Texas,2005,M12,5.0,562663,11246430,10683767
Oregon,2016,M02,5.3,106865,2022510,1915645
Wyoming,2013,M05,4.4,13523,304599,291076
Delaware,2009,M12,8.4,36157,429847,393690
Alaska,2000,M06,6.4,21094,327361,306267
Massachusetts,2013,M11,6.1,212926,3513824,3300898
Utah,2014,M12,3.3,47691,1440053,1392362
Florida,2006,M01,3.1,275513,8774375,8498862
Colorado,2014,M01,6.3,175337,2772003,2596666
Utah,2015,M10,3.4,50352,1479043,1428691
Nevada,2009,M04,10.6,143344,1349093,1205749
Vermont,2011,M04,6.0,21355,354994,333639
South Carolina,2002,M05,5.4,105443,1954089,1848646
Virginia,2004,M11,3.4,131504,3812113,3680609
Idaho,2003,M07,5.2,36504,698835,662331
New York,2015,M08,4.9,474347,9617422,9143075
South Carolina,2013,M09,7.3,159590,2196318,2036728
Arizona,2009,M03,8.9,276839,3115010,2838171
Louisiana,2014,M03,5.6,117808,2110590,1992782
Rhode Island,2015,M10,5.1,28427,552719,524292
New Jersey,2010,M02,10.3,465656,4534321,4068665
Georgia,2014,M02,7.5,355470,4735001,4379531
Connecticut,2001,M03,3.2,56536,1752656,1696120
Delaware,2006,M02,4.3,18786,437619,418833
Colorado,2003,M07,6.0,151630,2510876,2359246
District of Columbia,2012,M04,8.6,30738,357175,326437
Idaho,2013,M03,7.1,54244,765212,710968
Utah,2008,M04,3.0,40236,1361620,1321384
Hawaii,2005,M11,2.8,18028,633707,615679
New Jersey,2010,M12,9.1,414262,4542589,4128327
Illinois,2002,M06,7.0,448302,6432259,5983957
New Hampshire,2016,M08,2.8,20933,758169,737236
Kentucky,2010,M03,11.0,225506,2051953,1826447
North Carolina,2012,M04,8.7,404690,4641263,4236573
Puerto Rico,2014,M12,12.1,136051,1128553,992502
North Dakota,2008,M09,2.6,9610,370856,361246
Wyoming,2001,M04,3.8,10228,266819,256591
New Mexico,2016,M02,6.7,62267,926499,864232
New Hampshire,2009,M02,6.3,47177,743119,695942
Massachusetts,2002,M07,5.5,192672,3481656,3288984
Utah,2002,M11,5.5,64920,1190905,1125985
Hawaii,2011,M04,6.5,42815,663706,620891
Maryland,2000,M11,3.5,97496,2820942,2723446
Illinois,2007,M10,4.8,323538,6701860,6378322
California,2011,M09,11.5,2123813,18511086,16387273
North Dakota,2012,M08,2.8,11366,405325,393959
Delaware,2014,M08,5.8,26741,458664,431923
Illinois,2004,M10,5.8,366009,6345590,5979581
Utah,2011,M05,6.8,91821,1345682,1253861
Georgia,2006,M04,4.5,210883,4659793,4448910
South Carolina,2006,M01,6.8,140031,2065351,1925320
Ohio,2015,M11,4.5,257198,5694217,5437019
Washington,2008,M10,5.4,189309,3509314,3320005
Montana,2002,M07,3.8,18139,476578,458439
Rhode Island,2003,M12,4.8,26883,559138,532255
Kansas,2004,M10,5.1,75496,1469695,1394199
Georgia,2015,M10,5.7,272180,4793275,4521095
Illinois,2006,M05,4.3,278946,6466422,6187476
Oregon,2006,M11,5.1,97060,1916098,1819038
Indiana,2003,M12,5.0,158305,3156450,2998145
Minnesota,2016,M12,4.1,121941,2994599,2872658
Florida,2008,M12,8.1,740478,9163693,8423215
North Carolina,2009,M07,10.8,498541,4620069,4121528
Arkansas,2015,M12,4.2,55666,1334397,1278731
New York,2002,M09,5.6,521143,9279608,8758465
Arkansas,2004,M06,6.1,80314,1318326,1238012
North Carolina,2003,M01,6.9,288078,4194611,3906533
Louisiana,2001,M01,6.4,129953,2025284,1895331
New Jersey,2008,M02,5.1,228870,4465375,4236505
Indiana,2006,M01,5.4,171980,3195088,3023108
South Dakota,2007,M03,3.4,14728,438251,423523
Iowa,2004,M02,5.1,81697,1594184,1512487
Puerto Rico,2016,M08,12.0,133047,1106765,973718
Nevada,2006,M12,4.0,52150,1308795,1256645
Michigan,2012,M02,9.6,445792,4639268,4193476
Hawaii,2008,M04,3.5,22584,644071,621487
Pennsylvania,2000,M03,4.4,264019,6069385,5805366
North Carolina,2014,M04,5.8,272459,4662351,4389892
North Dakota,2008,M06,3.4,13060,381526,368466
Colorado,2001,M03,3.3,76950,2360223,2283273
South Carolina,2012,M08,9.5,208935,2202225,1993290
Montana,2005,M12,4.1,19994,484232,464238
Delaware,2002,M03,4.4,18384,419441,401057
Louisiana,2007,M04,4.0,79295,2004325,1925030
Pennsylvania,2010,M10,7.6,484808,6355519,5870711
Mississippi,2007,M05,6.0,77413,1294975,1217562
Puerto Rico,2002,M04,12.0,158832,1321075,1162243
West Virginia,2016,M04,6.1,47580,782789,735209
Florida,2004,M02,4.6,377643,8296237,7918594
South Carolina,2009,M07,11.6,253471,2185989,1932518
Idaho,2004,M08,4.4,31439,709571,678132
Pennsylvania,2003,M12,5.0,306795,6157457,5850662
Indiana,2013,M03,8.4,266419,3156068,2889649
Idaho,2006,M05,2.9,21274,744852,723578
Montana,2013,M11,5.1,26179,510730,484551
Rhode Island,2003,M04,5.2,28991,556214,527223
Florida,2009,M07,11.0,1007348,9183979,8176631
Massachusetts,2002,M11,5.2,177108,3431154,3254046
Ohio,2005,M04,5.9,347345,5857089,5509744
Vermont,2007,M12,3.9,13693,351668,337975
Wyoming,2009,M05,6.5,19606,300307,280701
Maine,2010,M12,8.0,55606,693997,638391
Iowa,2010,M09,5.5,92103,1673810,1581707
New Jersey,2015,M12,4.5,204122,4511058,4306936
North Dakota,2011,M06,3.8,14909,396939,382030
Maryland,2009,M07,7.2,223183,3087399,2864216
Kentucky,2014,M08,6.0,119230,1990026,1870796
Tennessee,2013,M12,6.5,197475,3020608,2823133
South Carolina,2006,M05,6.2,131361,2113520,1982159
Nebraska,2002,M08,3.4,32831,956334,923503
Oregon,2001,M12,7.6,138618,1821313,1682695
South Dakota,2008,M10,3.0,13537,448776,435239
Florida,2011,M03,10.1,934511,9261129,8326618
North Dakota,2003,M04,4.0,13670,340584,326914
Wyoming,2014,M11,4.1,12708,306418,293710
Arkansas,2007,M11,4.8,65016,1367285,1302269
Puerto Rico,2007,M03,10.2,145870,1427612,1281742
Maryland,2011,M12,6.8,210020,3095540,2885520
Florida,2010,M04,10.6,974509,9208161,8233652
Arizona,2013,M08,8.3,254184,3045993,2791809
District of Columbia,2012,M06,9.2,33689,368172,334483
Massachusetts,2016,M01,4.9,175361,3569436,3394075
Puerto Rico,2002,M09,12.6,165820,1319974,1154154
Nebraska,2014,M08,3.1,31521,1012222,980701
New York,2003,M03,6.4,596335,9248750,8652415
Puerto Rico,2000,M08,11.2,143362,1275245,1131883
Colorado,2011,M04,8.4,226851,2714172,2487321
Oregon,2005,M05,6.0,109478,1835609,1726131
Arizona,2016,M12,4.7,152384,3261413,3109029
Alabama,2006,M06,4.6,99321,2182463,2083142
Kansas,2001,M04,3.7,50635,1382486,1331851
New Mexico,2008,M09,4.6,43749,947843,904094
Maryland,2012,M05,6.8,212528,3109290,2896762
South Carolina,2000,M11,3.4,67542,1980088,1912546
Nebraska,2010,M01,5.4,53260,980564,927304
Idaho,2009,M04,7.6,56151,742272,686121
Hawaii,2007,M06,3.3,21197,643425,622228
California,2015,M10,5.7,1070733,18912676,17841943
Alaska,2000,M01,7.4,23372,315208,291836
Iowa,2000,M03,2.8,44602,1586855,1542253
Texas,2014,M06,5.4,710460,13067923,12357463
Ohio,2002,M04,5.9,345173,5836632,5491459
Hawaii,2009,M07,7.4,47083,638122,591039
Tennessee,2011,M06,9.6,303073,3158176,2855103
Iowa,2007,M04,3.7,60767,1651693,1590926
Connecticut,2009,M04,7.4,138130,1873906,1735776
Arkansas,2003,M11,5.5,69806,1274942,1205136
Maryland,2009,M02,6.8,205622,3006471,2800849
Nebraska,2006,M01,3.7,35575,957962,922387
Arkansas,2000,M11,3.9,48070,1246247,1198177
Puerto Rico,2014,M03,14.2,162490,1145583,983093
Alaska,2006,M02,7.9,27369,344476,317107
Mississippi,2016,M08,5.6,71743,1272765,1201022
Florida,2006,M08,3.6,329695,9086078,8756383
Colorado,2014,M05,5.0,139195,2796341,2657146
Rhode Island,2005,M04,4.8,26837,558458,531621
Washington,2007,M08,4.5,153721,3415016,3261295
Tennessee,2007,M03,4.4,135074,3058738,2923664
Wisconsin,2007,M08,4.7,144578,3103563,2958985
Washington,2001,M09,5.9,178912,3022716,2843804
West Virginia,2009,M02,7.5,60919,808836,747917
Oklahoma,2015,M02,4.4,79891,1816362,1736471
New Mexico,2013,M08,7.1,65451,921406,855955
North Carolina,2001,M02,5.0,209858,4200035,3990177
Utah,2001,M12,4.8,55984,1169414,1113430
Minnesota,2005,M09,3.7,107746,2886677,2778931
Delaware,2015,M08,5.0,23372,471811,448439
South Carolina,2003,M11,6.9,138247,1998167,1859920
Kentucky,2011,M07,9.8,201922,2062982,1861060
New Mexico,2002,M02,5.6,48070,864745,816675
Texas,2013,M06,6.8,884426,12963603,12079177
Texas,2002,M09,6.3,680412,10822434,10142022
Michigan,2014,M08,7.3,350351,4778821,4428470
New York,2016,M12,4.5,420764,9437309,9016545
Alaska,2007,M06,6.4,22759,357854,335095
Idaho,2014,M04,5.0,38793,774761,735968
Hawaii,2003,M09,4.6,27399,600093,572694
Ohio,2000,M10,3.4,193876,5784277,5590401
California,2005,M01,6.2,1069341,17383644,16314303
Nevada,2003,M05,4.9,56039,1140212,1084173
Alaska,2015,M01,7.2,25798,359313,333515
Wyoming,2014,M07,3.8,11871,311218,299347
Alaska,2001,M01,7.5,23565,315521,291956
Utah,2011,M04,7.0,93481,1342349,1248868
New Jersey,2001,M08,4.4,188430,4302320,4113890
Illinois,2009,M03,9.8,648334,6585694,5937360
California,2004,M01,7.0,1216022,17314954,16098932
Puerto Rico,2014,M08,15.3,173624,1132306,958682
Idaho,2006,M06,3.0,22310,755754,733444
New Jersey,2013,M12,6.7,299424,4461128,4161704
Pennsylvania,2013,M08,7.5,486259,6484479,5998220
Maryland,2005,M10,3.8,112664,2942060,2829396
Puerto Rico,2003,M01,11.4,151864,1333783,1181919
Colorado,2002,M06,5.8,142041,2461103,2319062
Nebraska,2007,M01,3.4,33057,962735,929678
Missouri,2000,M10,3.5,104466,2973475,2869009
Wyoming,2013,M11,4.4,13608,306599,292991
Iowa,2000,M08,2.5,39423,1585860,1546437
Indiana,2016,M12,4.0,131025,3287532,3156507
Minnesota,2003,M12,4.8,136141,2862736,2726595
Rhode Island,2006,M09,4.4,24958,573224,548266
South Dakota,2002,M05,2.9,12079,417621,405542
Alaska,2005,M01,8.1,27374,337749,310375
Alaska,2004,M06,7.6,26143,343296,317153
Tennessee,2013,M02,8.3,254623,3077887,2823264
Nevada,2016,M11,5.0,71570,1433620,1362050
Connecticut,2011,M04,8.8,167551,1906910,1739359
Kentucky,2016,M08,4.8,95780,1990054,1894274
Maryland,2007,M08,3.4,102917,2987241,2884324
Idaho,2010,M05,8.3,63489,762017,698528
Maine,2014,M04,6.2,43074,693171,650097
Wyoming,2005,M10,3.3,9132,278349,269217
West Virginia,2000,M04,5.4,43809,809020,765211
Oklahoma,2006,M04,3.7,62271,1703579,1641308
Virginia,2005,M05,3.6,142120,3907807,3765687
Alaska,2014,M02,8.0,28795,361940,333145
Arizona,2013,M03,7.5,227177,3010932,2783755
Colorado,2005,M06,5.2,135356,2579273,2443917
Louisiana,2002,M03,5.8,114939,1986697,1871758
California,2011,M07,12.2,2252178,18464952,16212774
Pennsylvania,2003,M02,6.5,396881,6143896,5747015
Kentucky,2005,M12,5.7,115074,2011891,1896817
Connecticut,2005,M03,5.1,91032,1773886,1682854
South Dakota,2001,M07,3.0,12560,423229,410669
Wyoming,2001,M11,3.8,10125,269246,259121
Idaho,2009,M03,8.8,65677,748196,682519
Illinois,2009,M01,8.8,576541,6543091,5966550
Kentucky,2014,M03,7.9,159932,2036886,1876954
Louisiana,2016,M08,6.5,138745,2118794,1980049
Indiana,2004,M12,5.5,173333,3160273,2986940
Connecticut,2006,M08,4.6,84352,1851537,1767185
New Hampshire,2000,M01,3.2,21590,679031,657441
Montana,2001,M11,4.4,20138,461677,441539
Delaware,2001,M08,3.3,14063,423030,408967
Texas,2004,M04,5.7,627430,10940499,10313069
Arkansas,2014,M02,7.2,92554,1287426,1194872
New York,2015,M11,4.8,459022,9543901,9084879
Nevada,2006,M02,4.1,51800,1259892,1208092
Mississippi,2013,M12,7.8,97082,1251623,1154541
New York,2012,M11,7.8,744437,9592623,8848186
Wyoming,2002,M05,3.8,10127,267714,257587
Arkansas,2008,M10,5.4,74462,1378564,1304102
Delaware,2016,M07,4.6,21762,478124,456362
New Hampshire,2015,M11,2.9,21576,742372,720796
New Hampshire,2012,M11,5.3,39438,740761,701323
Utah,2005,M02,4.8,59307,1247373,1188066
Wyoming,2003,M09,3.6,9882,274308,264426
Indiana,2001,M01,4.1,129381,3133728,3004347
Louisiana,2011,M03,7.8,162062,2064681,1902619
Connecticut,2012,M03,8.5,160375,1889433,1729058
Mississippi,2008,M09,6.9,89270,1297632,1208362
Kansas,2013,M02,5.8,85957,1482404,1396447
Oregon,2010,M04,11.0,218040,1978423,1760383
Tennessee,2015,M02,6.0,182538,3039683,2857145
Connecticut,2014,M06,6.6,126262,1901322,1775060
Iowa,2015,M11,3.3,55312,1697542,1642230
California,2014,M04,7.3,1353441,18613370,17259929
Mississippi,2009,M05,9.4,119682,1276851,1157169
Ohio,2006,M07,5.8,352652,6034763,5682111
North Carolina,2015,M09,5.4,256447,4756498,4500051
Kentucky,2007,M03,5.9,120445,2039537,1919092
Pennsylvania,2000,M01,4.7,283411,6051746,5768335
West Virginia,2004,M03,6.2,48282,777284,729002
Maine,2001,M01,4.0,26538,663946,637408
Arkansas,2012,M06,7.8,106146,1368973,1262827
Oklahoma,2002,M03,4.6,78060,1685661,1607601
Louisiana,2013,M06,7.9,170435,2147893,1977458
Alaska,2010,M12,8.0,28778,360758,331980
Michigan,2016,M07,5.8,282996,4891813,4608817
Illinois,2010,M10,9.3,610061,6585059,5974998
Kentucky,2014,M01,8.0,161394,2014792,1853398
New York,2004,M11,5.1,479541,9400962,8921421
Missouri,2016,M07,5.2,162471,3145778,2983307
Alaska,2012,M02,8.3,29994,362206,332212
Delaware,2012,M11,6.7,29994,444690,414696
New York,2008,M11,5.9,573044,9696878,9123834
Puerto Rico,2001,M02,11.4,145998,1276411,1130413
Colorado,2003,M01,6.4,155703,2449068,2293365
Louisiana,2002,M01,6.9,135561,1971495,1835934
Kansas,2005,M07,5.3,78200,1484705,1406505
New Jersey,2001,M09,4.3,185491,4269753,4084262
Georgia,2013,M10,8.0,377781,4724090,4346309
District of Columbia,2002,M01,6.9,21011,305446,284435
New Mexico,2011,M02,7.6,70517,926884,856367
Oregon,2014,M12,5.8,113007,1938312,1825305
Ohio,2006,M09,5.2,310182,5961812,5651630
Arizona,2016,M11,4.8,155867,3265507,3109640
North Dakota,2000,M04,3.1,10470,340148,329678
New York,2006,M08,4.4,421192,9577522,9156330
Connecticut,2013,M06,8.0,150443,1890872,1740429
Arizona,2012,M02,8.4,255111,3020747,2765636
Georgia,2011,M05,10.0,474010,4743057,4269047
Kansas,2006,M05,4.1,60066,1457021,1396955
Oregon,2010,M02,11.9,233304,1962701,1729397
Illinois,2012,M01,9.7,633734,6509012,5875278
Tennessee,2015,M04,5.3,162859,3057428,2894569
Rhode Island,2016,M03,5.9,32590,548781,516191
North Dakota,2012,M06,3.3,13307,406660,393353
Louisiana,2010,M06,8.6,183943,2128856,1944913
Colorado,2013,M03,7.5,207624,2757905,2550281
California,2002,M11,6.8,1171647,17260204,16088557
Indiana,2000,M01,3.6,112995,3120756,3007761
Wyoming,2003,M07,3.8,10561,278799,268238
Oregon,2003,M02,8.7,159536,1834770,1675234
Colorado,2008,M09,4.9,132802,2730903,2598101
Iowa,2010,M07,5.6,95549,1693442,1597893
Arizona,2009,M04,8.9,279248,3126747,2847499
Washington,2009,M04,8.3,289839,3512984,3223145
Minnesota,2015,M05,3.5,105859,2987446,2881587
Montana,2003,M05,4.1,19416,471174,451758
West Virginia,2008,M07,3.9,31594,819438,787844
Indiana,2004,M01,5.9,184611,3153630,2969019
Nebraska,2016,M03,3.3,33719,1008495,974776
Minnesota,2012,M12,5.3,155488,2945378,2789890
Oklahoma,2014,M07,4.5,81561,1795522,1713961
Nevada,2015,M01,7.6,106390,1402923,1296533
South Carolina,2002,M09,5.6,108956,1955442,1846486
Ohio,2001,M04,3.8,217346,5780976,5563630
Arkansas,2003,M06,6.4,82699,1289590,1206891
Kentucky,2005,M01,6.1,120371,1958083,1837712
Minnesota,2002,M02,5.3,149208,2840637,2691429
New York,2002,M10,5.8,536360,9304796,8768436
Washington,2003,M11,7.1,223986,3156786,2932800
Colorado,2016,M08,3.2,93703,2910544,2816841
North Dakota,2015,M06,3.1,13015,423106,410091
South Carolina,2003,M10,6.8,137265,2005295,1868030
North Dakota,2006,M10,2.5,8999,363685,354686
West Virginia,2004,M01,6.3,48644,776047,727403
Maine,2001,M03,4.1,27223,664203,636980
New York,2012,M02,9.4,896719,9570383,8673664
Nevada,2014,M01,9.0,123879,1382100,1258221
Colorado,2004,M03,6.0,151282,2503322,2352040
Alabama,2006,M05,3.6,77036,2152499,2075463
South Carolina,2011,M08,11.0,241219,2201176,1959957
Oklahoma,2002,M01,4.9,82585,1669143,1586558
West Virginia,2003,M04,6.4,50386,789047,738661
Oklahoma,2005,M04,4.2,70823,1692423,1621600
Virginia,2015,M10,4.0,168607,4180883,4012276
Puerto Rico,2012,M10,14.5,171498,1184584,1013086
Texas,2003,M01,7.0,755097,10836465,10081368
Maine,2014,M02,7.1,49031,693464,644433
New York,2015,M03,5.7,545038,9576102,9031064
New Mexico,2007,M04,3.5,32312,926009,893697
Kentucky,2012,M10,7.6,156683,2065254,1908571
Arkansas,2011,M08,8.1,110931,1365720,1254789
New Mexico,2009,M02,6.7,63475,940625,877150
Alaska,2005,M03,7.7,26133,339022,312889
Delaware,2004,M07,4.1,17655,425837,408182
District of Columbia,2002,M03,6.5,19870,306621,286751
Wyoming,2012,M01,6.5,19787,305451,285664
Washington,2003,M06,7.6,239141,3137720,2898579
Connecticut,2011,M02,9.6,183533,1904085,1720552
Nebraska,2007,M06,3.3,32910,992626,959716
Mississippi,2004,M10,6.6,86833,1317698,1230865
Maryland,2006,M08,4.1,122818,2993743,2870925
Illinois,2010,M04,10.5,701396,6657886,5956490
New Jersey,2000,M03,3.9,168785,4291139,4122354
Massachusetts,2008,M09,5.9,204353,3450201,3245848
Wyoming,2004,M04,3.8,10236,272410,262174
Arkansas,2016,M07,4.4,59883,1360570,1300687
Minnesota,2004,M07,4.6,133889,2915266,2781377
North Dakota,2011,M12,3.3,12701,387835,375134
Texas,2015,M01,4.7,609832,12976314,12366482
Alaska,2004,M01,8.8,29017,330189,301172
Iowa,2012,M03,5.5,90665,1650594,1559929
Ohio,2013,M06,8.0,461121,5793315,5332194
Virginia,2002,M07,4.3,162360,3774893,3612533
Alaska,2015,M12,6.6,23522,357258,333736
Hawaii,2014,M05,4.3,28759,664302,635543
Alabama,2002,M04,5.3,110349,2088023,1977674
Alaska,2016,M08,5.8,21301,366325,345024
Wyoming,2014,M05,4.0,12138,305415,293277
Virginia,2011,M09,6.7,284607,4230370,3945763
South Dakota,2015,M08,2.8,12812,455138,442326
Alaska,2003,M08,6.7,22657,336842,314185
Arizona,2010,M11,10.0,305994,3068780,2762786
Georgia,2016,M08,5.6,273846,4920833,4646987
Florida,2002,M05,5.4,437325,8111647,7674322
Tennessee,2003,M03,5.6,163255,2909720,2746465
Texas,2006,M06,5.4,615971,11381178,10765207
District of Columbia,2014,M09,8.0,30298,380511,350213
Georgia,2012,M07,9.8,471571,4817918,4346347
Tennessee,2003,M06,6.4,188810,2964305,2775495
Nebraska,2000,M06,3.0,29150,958847,929697
Missouri,2015,M01,6.0,184052,3076515,2892463
South Dakota,2002,M07,2.8,12097,427651,415554
South Carolina,2016,M12,4.2,95277,2283712,2188435
Oregon,2011,M06,9.6,192711,2006993,1814282
New Jersey,2009,M03,8.8,399216,4534698,4135482
Vermont,2001,M04,3.6,11817,332116,320299
Pennsylvania,2007,M10,4.1,259906,6352023,6092117
Montana,2011,M09,6.0,30049,502215,472166
Puerto Rico,2000,M06,10.1,132625,1307489,1174864
Illinois,2013,M07,9.4,627740,6656717,6028977
New Mexico,2002,M04,5.3,45983,866725,820742
Kentucky,2005,M11,5.8,116362,2015350,1898988
South Dakota,2011,M09,4.1,18081,438158,420077
Michigan,2005,M05,6.7,339637,5099832,4760195
North Dakota,2008,M07,3.1,11790,381067,369277
Nevada,2014,M03,8.6,119418,1393366,1273948
Ohio,2014,M06,5.9,338626,5740276,5401650
Missouri,2014,M01,7.1,213399,3017788,2804389
New Hampshire,2000,M06,2.7,18614,695922,677308
Hawaii,2000,M06,4.8,29214,609797,580583
Kansas,2006,M10,4.1,59781,1474131,1414350
New York,2002,M04,6.1,565785,9217595,8651810
Indiana,2011,M02,9.6,301388,3133592,2832204
New Hampshire,2003,M05,4.1,28925,700892,671967
Maine,2000,M05,3.3,22183,675872,653689
Vermont,2000,M07,2.7,9190,336105,326915
Texas,2005,M06,5.7,632359,11125793,10493434
Alabama,2001,M04,4.2,88272,2106889,2018617
Tennessee,2010,M03,10.6,323903,3067457,2743554
Vermont,2009,M09,6.0,21462,357469,336007
Idaho,2013,M01,7.7,58795,762474,703679
Wisconsin,2008,M08,4.7,146058,3112870,2966812
Georgia,2007,M05,4.1,196987,4783637,4586650
Washington,2016,M12,5.3,193221,3666401,3473180
Texas,2015,M10,4.4,578499,13075768,12497269
Pennsylvania,2009,M05,8.0,515247,6421733,5906486
Rhode Island,2016,M11,4.6,25413,553212,527799
Georgia,2009,M08,10.3,494225,4787181,4292956
Illinois,2004,M04,6.0,376476,6262835,5886359
Connecticut,2009,M02,7.5,140150,1869648,1729498
Kentucky,2002,M02,6.5,126021,1938464,1812443
Kentucky,2016,M01,5.9,114577,1956786,1842209
Michigan,2015,M09,4.6,215607,4729956,4514349
Connecticut,2011,M11,8.0,151964,1905864,1753900
Mississippi,2011,M02,10.4,139934,1339604,1199670
Ohio,2003,M07,6.6,390769,5941841,5551072
Utah,2003,M09,5.2,63027,1204244,1141217
Idaho,2012,M01,8.9,67956,762247,694291
Maryland,2013,M09,6.3,195458,3121502,2926044
New Hampshire,2015,M06,3.4,25227,750506,725279
Maine,2014,M11,5.2,35515,686266,650751
Virginia,2006,M05,3.1,121634,3977626,3855992
Mississippi,2006,M12,6.3,82625,1309369,1226744
Maryland,2011,M01,7.8,239389,3070395,2831006
Idaho,2013,M07,5.9,45960,783242,737282
New Jersey,2012,M01,9.6,434250,4534225,4099975
Florida,2007,M09,4.5,414185,9215280,8801095
Vermont,2013,M06,4.6,16199,355956,339757
New York,2007,M08,4.5,433427,9558623,9125196
Vermont,2000,M01,3.4,11117,326873,315756
Pennsylvania,2008,M10,5.3,342190,6481940,6139750
Pennsylvania,2006,M07,5.0,319736,6398857,6079121
New Hampshire,2007,M04,3.7,26781,730343,703562
Missouri,2008,M06,5.9,182146,3067424,2885278
Nevada,2013,M04,9.8,135455,1379077,1243622
Vermont,2007,M04,4.4,15595,350734,335139
Alabama,2001,M01,5.2,110035,2118911,2008876
Alaska,2001,M08,5.3,17369,327623,310254
Alabama,2010,M05,9.9,219339,2213429,1994090
Arkansas,2015,M03,5.6,73717,1319436,1245719
District of Columbia,2010,M07,9.4,33641,356243,322602
Florida,2015,M08,5.6,536825,9620634,9083809
Alaska,2013,M12,7.0,25217,361373,336156
Alabama,2004,M08,5.9,126954,2142274,2015320
Wyoming,2007,M10,2.4,6967,288442,281475
New Jersey,2015,M04,5.9,267843,4525836,4257993
Utah,2006,M08,3.0,40567,1333618,1293051
Hawaii,2013,M11,4.8,31784,658036,626252
Iowa,2011,M08,5.4,90193,1656838,1566645
Illinois,2013,M01,10.4,679826,6557751,5877925
Arkansas,2010,M09,7.9,106797,1357050,1250253
Nebraska,2009,M04,4.6,46017,994052,948035
Illinois,2002,M12,6.4,400582,6278939,5878357
Missouri,2014,M03,7.2,219153,3053675,2834522
Michigan,2016,M05,4.5,218781,4834360,4615579
Wisconsin,2003,M10,4.7,142219,3044684,2902465
Alabama,2009,M06,11.9,260376,2189836,1929460
Colorado,2013,M06,7.3,205407,2805607,2600200
New Hampshire,2012,M01,6.0,44160,736942,692782
Mississippi,2010,M12,10.3,139813,1356512,1216699
North Dakota,2003,M12,3.5,12159,343683,331524
New York,2012,M04,8.2,781708,9525644,8743936
Delaware,2015,M01,5.5,25060,459034,433974
Indiana,2009,M02,10.4,333790,3210104,2876314
Virginia,2016,M08,4.3,183143,4250825,4067682
Delaware,2003,M10,3.9,16116,416013,399897
Oklahoma,2016,M09,4.9,89975,1827050,1737075
Utah,2012,M04,5.5,74094,1359212,1285118
Virginia,2003,M03,4.3,161341,3750051,3588710
Illinois,2011,M01,10.1,657676,6512151,5854475
Vermont,2004,M10,2.8,9728,347720,337992
North Carolina,2010,M01,12.0,549257,4560748,4011491
District of Columbia,2005,M02,7.4,23485,317597,294112
Idaho,2016,M01,4.9,38813,798986,760173
Tennessee,2011,M09,8.9,278040,3130501,2852461
Missouri,2005,M11,5.2,156309,3013456,2857147
New Mexico,2012,M06,7.8,73175,934947,861772
Wyoming,2013,M06,4.5,13964,311450,297486
Mississippi,2009,M02,8.9,114198,1280391,1166193
Virginia,2002,M01,4.6,166697,3651633,3484936
Arizona,2002,M10,6.0,163567,2711184,2547617
South Carolina,2013,M08,7.8,172097,2213006,2040909
Texas,2009,M11,8.0,956207,12018286,11062079
Alaska,2006,M10,6.0,20839,347925,327086
Washington,2010,M04,10.0,351319,3524629,3173310
Kentucky,2000,M05,4.1,79923,1968551,1888628
Pennsylvania,2004,M08,5.4,336067,6273155,5937088
Pennsylvania,2004,M01,6.2,382203,6160274,5778071
Indiana,2005,M09,5.2,165752,3213883,3048131
North Dakota,2016,M12,3.1,12674,412466,399792
Ohio,2016,M12,4.8,269865,5663487,5393622
New Mexico,2001,M03,5.0,42598,851882,809284
Iowa,2015,M02,4.5,76925,1701430,1624505
New Jersey,2008,M04,4.5,199812,4470180,4270368
Delaware,2010,M08,8.3,36480,438990,402510
New York,2008,M05,4.9,475046,9608312,9133266
Kentucky,2010,M01,11.5,235329,2038389,1803060
California,2015,M02,6.9,1297625,18873731,17576106
Connecticut,2006,M06,4.4,81485,1844286,1762801
Arizona,2007,M08,4.1,123561,3029461,2905900
Massachusetts,2016,M08,3.4,123037,3622631,3499594
Wisconsin,2015,M11,4.1,125770,3100885,2975115
Colorado,2013,M01,8.0,219059,2754533,2535474
District of Columbia,2015,M08,7.0,27172,387832,360660
Rhode Island,2011,M07,11.1,62654,566053,503399
Vermont,2008,M12,5.3,19141,357816,338675
Nebraska,2015,M04,2.9,28850,1007748,978898
Idaho,2002,M11,5.4,36944,684174,647230
Kansas,2003,M03,5.4,76844,1423257,1346413
Illinois,2016,M01,6.7,439742,6517381,6077639
Massachusetts,2011,M11,6.4,222129,3471254,3249125
New Jersey,2004,M12,3.9,170719,4339279,4168560
Arizona,2000,M09,4.0,101478,2511007,2409529
New Hampshire,2015,M05,3.3,24388,739010,714622
Kansas,2010,M01,7.7,115467,1500669,1385202
New Hampshire,2001,M08,3.7,25936,707245,681309
Utah,2014,M04,3.5,49720,1414315,1364595
Georgia,2016,M11,5.1,251828,4975427,4723599
Nebraska,2016,M01,3.5,35162,999380,964218
Connecticut,2005,M06,5.1,92986,1815764,1722778
Arkansas,2011,M12,7.8,106201,1357508,1251307
Alaska,2003,M11,7.8,25787,330164,304377
Alabama,2013,M06,7.7,168532,2188077,2019545
District of Columbia,2011,M02,10.0,35071,351291,316220
Mississippi,2010,M05,10.4,131358,1267073,1135715
Louisiana,2002,M06,7.1,144320,2042356,1898036
South Carolina,2008,M08,7.5,162877,2165963,2003086
Georgia,2002,M09,4.8,206733,4350815,4144082
South Carolina,2001,M12,5.8,110516,1919095,1808579
New Mexico,2006,M01,4.4,40306,914501,874195
Montana,2005,M11,3.8,18679,486002,467323
Louisiana,2003,M04,6.1,122223,2015302,1893079
Massachusetts,2010,M11,7.7,268236,3474893,3206657
Wisconsin,2012,M11,6.2,190078,3068600,2878522
Oregon,2001,M03,6.3,114781,1815030,1700249
Virginia,2002,M05,4.2,156860,3739128,3582268
Hawaii,2001,M12,4.9,29854,607399,577545
Maine,2002,M12,4.6,30855,675187,644332
Puerto Rico,2005,M07,11.9,165718,1388588,1222870
Indiana,2010,M05,10.3,328378,3196453,2868075
Arizona,2009,M01,8.5,265168,3116556,2851388
Nevada,2012,M08,11.0,152082,1378528,1226446
Washington,2004,M02,7.5,238411,3175155,2936744
Utah,2005,M07,4.2,53315,1284407,1231092
Maine,2013,M03,7.8,54158,698006,643848
Alabama,2015,M07,6.6,143867,2166130,2022263
Indiana,2000,M04,3.0,95209,3136791,3041582
New Jersey,2010,M04,9.4,428981,4569810,4140829
Missouri,2006,M07,5.1,157155,3063552,2906397
Michigan,2003,M07,8.3,419732,5082739,4663007
Georgia,2010,M12,10.6,500248,4721252,4221004
Kansas,2007,M07,4.6,69009,1507549,1438540
Louisiana,2010,M08,8.7,183080,2110999,1927919
Indiana,2013,M12,6.3,202067,3182841,2980774
Georgia,2012,M05,9.0,432637,4797221,4364584
Vermont,2005,M07,3.3,11833,355615,343782
Arkansas,2000,M01,5.1,63187,1241071,1177884
North Dakota,2010,M12,3.7,13899,377614,363715
Hawaii,2006,M11,2.4,15180,642198,627018
Alaska,2001,M03,7.1,22481,316498,294017
Wyoming,2015,M07,3.9,12214,310245,298031
North Dakota,2007,M04,3.3,12105,365153,353048
Indiana,2015,M07,4.7,154722,3295812,3141090
California,2007,M06,5.3,940705,17898759,16958054
Puerto Rico,2011,M02,16.3,199954,1228820,1028866
Maine,2006,M03,5.2,35629,690865,655236
Iowa,2001,M05,2.8,45445,1602351,1556906
Colorado,2015,M04,4.0,113907,2817246,2703339
Oregon,2005,M12,5.4,100241,1844936,1744695
Washington,2011,M06,9.4,325617,3474431,3148814
Maine,2000,M07,3.0,20726,695482,674756
Maine,2014,M10,4.7,32629,694047,661418
Vermont,2000,M05,2.5,8247,328242,319995
Hawaii,2013,M10,5.0,32440,652210,619770
Massachusetts,2015,M07,5.1,184597,3626880,3442283
Nebraska,2015,M06,3.3,33637,1020384,986747
New Mexico,2010,M12,7.3,68499,933590,865091
Arkansas,2008,M11,5.9,80814,1371117,1290303
West Virginia,2007,M02,5.7,45858,803817,757959
Michigan,2004,M05,6.8,344477,5057232,4712755
Oklahoma,2001,M02,3.5,57837,1659203,1601366
New Jersey,2016,M05,5.0,224726,4524636,4299910
Alabama,2007,M12,4.3,93382,2189983,2096601
Pennsylvania,2009,M07,8.5,554104,6509296,5955192
Alabama,2001,M05,4.0,84256,2097935,2013679
Arizona,2012,M07,9.2,278251,3038623,2760372
Wisconsin,2003,M09,5.0,151213,3040957,2889744
Arkansas,2002,M04,5.4,69132,1269317,1200185
Alabama,2000,M09,4.5,95292,2123398,2028106
Maryland,2010,M04,7.3,224331,3052600,2828269
District of Columbia,2007,M02,5.7,18172,320662,302490
South Dakota,2012,M11,3.9,17344,443429,426085
Puerto Rico,2016,M02,11.6,131565,1133795,1002230
Kansas,2005,M06,5.1,76255,1483662,1407407
Connecticut,2006,M12,3.7,68354,1837579,1769225
Arkansas,2010,M10,7.6,103589,1356327,1252738
Hawaii,2010,M04,6.7,43308,643393,600085
South Carolina,2004,M11,6.8,139685,2041692,1902007
South Carolina,2011,M11,10.0,215727,2166255,1950528
New Jersey,2005,M03,4.8,208148,4347039,4138891
Tennessee,2010,M08,9.3,288952,3106385,2817433
Utah,2011,M10,5.9,80254,1353118,1272864
Nevada,2010,M03,13.6,183360,1352551,1169191
Florida,2015,M12,4.9,469345,9642554,9173209
Idaho,2014,M02,6.0,46128,772092,725964
Wisconsin,2011,M08,7.5,232084,3100780,2868696
Oregon,2005,M02,7.3,133443,1825949,1692506
Nebraska,2008,M06,3.5,34901,1001715,966814
Maine,2012,M09,6.5,45547,701925,656378
New Mexico,2009,M08,8.0,75217,941879,866662
Missouri,2013,M01,7.6,227213,3007584,2780371
Washington,2013,M01,8.4,288920,3451261,3162341
Louisiana,2010,M09,8.2,172831,2095578,1922747
New Mexico,2000,M12,4.4,37736,856393,818657
New Jersey,2007,M10,3.9,172296,4433524,4261228
Utah,2001,M11,4.4,51877,1169906,1118029
New Hampshire,2008,M02,4.2,31342,738309,706967
Nebraska,2006,M10,2.8,27243,972004,944761
Nebraska,2016,M04,3.1,31031,1011041,980010
New Hampshire,2010,M07,5.6,41936,750419,708483
Connecticut,2013,M09,7.5,139133,1866194,1727061
Mississippi,2009,M03,8.8,111668,1273045,1161377
West Virginia,2013,M09,6.0,48157,799428,751271
Oklahoma,2011,M09,5.8,103946,1783249,1679303
Kentucky,2006,M09,5.3,108664,2031268,1922604
Oregon,2003,M10,7.3,134853,1844763,1709910
New Mexico,2008,M10,4.6,44325,953521,909196
Florida,2016,M08,5.2,509388,9867355,9357967
North Carolina,2014,M03,6.7,313869,4689163,4375294
Minnesota,2012,M07,5.8,172165,2980604,2808439
Kansas,2002,M06,5.2,74672,1430173,1355501
Idaho,2012,M03,8.3,63204,765134,701930
Iowa,2006,M02,4.4,71883,1636988,1565105
Montana,2000,M05,4.5,21077,468843,447766
District of Columbia,2012,M03,9.4,33430,357157,323727
Minnesota,2014,M08,3.8,111779,2970631,2858852
Washington,2011,M01,10.5,362227,3458007,3095780
Virginia,2016,M12,3.8,160026,4237986,4077960
Kentucky,2010,M12,9.5,195614,2053627,1858013
Oregon,2009,M09,10.3,202876,1965711,1762835
Colorado,2013,M04,7.0,193725,2760780,2567055
Virginia,2006,M11,2.8,112870,4001706,3888836
Maryland,2009,M04,6.5,194707,3011036,2816329
Indiana,2016,M06,4.6,153573,3367532,3213959
Nebraska,2003,M05,3.9,37503,967984,930481
Georgia,2016,M02,5.4,264387,4867137,4602750
Minnesota,2003,M06,5.2,151787,2906610,2754823
Puerto Rico,2010,M08,16.4,205507,1253107,1047600
Nebraska,2006,M09,2.9,27482,963268,935786
Utah,2002,M06,6.2,73974,1189932,1115958
Indiana,2006,M11,4.6,148182,3239229,3091047
Idaho,2015,M01,5.2,40728,781268,740540
North Carolina,2011,M04,9.9,457156,4625987,4168831
Pennsylvania,2004,M12,4.9,306196,6224912,5918716
Delaware,2003,M05,3.9,16084,412134,396050
Montana,2010,M11,7.1,35148,495977,460829
Massachusetts,2005,M03,5.1,172261,3358531,3186270
North Dakota,2006,M01,4.0,14155,352249,338094
Iowa,2012,M08,4.9,81309,1648299,1566990
Colorado,2013,M05,6.9,190568,2767673,2577105
Florida,2014,M02,6.6,622271,9497917,8875646
New Hampshire,2007,M06,3.5,25968,746054,720086
Iowa,2009,M09,5.9,99137,1675253,1576116
New Mexico,2001,M07,5.3,45430,865075,819645
Delaware,2004,M06,4.2,17823,424422,406599
Rhode Island,2002,M02,5.5,30003,543365,513362
California,2005,M07,5.5,974062,17636959,16662897
Hawaii,2015,M08,3.4,23022,675859,652837
Indiana,2004,M10,5.1,162002,3174364,3012362
Alaska,2001,M04,6.7,21030,316099,295069
Puerto Rico,2009,M01,13.3,175272,1322599,1147327
Puerto Rico,2007,M10,12.3,166338,1354349,1188011
North Dakota,2007,M03,3.9,14016,363776,349760
South Carolina,2001,M02,4.8,94319,1951126,1856807
Rhode Island,2001,M05,4.3,23280,538655,515375
Wisconsin,2000,M12,3.3,99765,2985544,2885779
Arkansas,2011,M02,9.2,123978,1350876,1226898
California,2001,M08,5.7,969392,17121638,16152246
Maine,2015,M05,4.4,30262,680957,650695
Wyoming,2009,M11,6.7,20164,300575,280411
New Hampshire,2005,M09,3.3,24309,725719,701410
Missouri,2010,M03,10.2,308911,3042856,2733945
Georgia,2008,M05,5.6,277996,4934638,4656642
New Jersey,2002,M10,5.5,239700,4341264,4101564
Colorado,2001,M06,3.7,89448,2399880,2310432
Maryland,2003,M03,4.6,132489,2865307,2732818
South Dakota,2010,M05,4.8,21243,441874,420631
Tennessee,2000,M08,4.2,117812,2833951,2716139
Washington,2000,M01,5.7,174360,3066412,2892052
Illinois,2013,M12,8.3,537476,6503838,5966362
Kentucky,2001,M05,4.7,91261,1958903,1867642
Virginia,2007,M03,2.9,118197,4017500,3899303
New York,2012,M08,8.5,819852,9640779,8820927
Illinois,2015,M04,5.5,352732,6460903,6108171
Delaware,2007,M06,3.6,15898,446972,431074
Alabama,2001,M06,5.2,110859,2119259,2008400
New Hampshire,2001,M01,3.2,22285,694047,671762
Florida,2013,M04,7.0,657955,9413240,8755285
Colorado,2008,M01,4.6,124627,2690625,2565998
South Carolina,2001,M11,5.6,108344,1923870,1815526
Minnesota,2004,M11,3.9,111833,2879853,2768020
Iowa,2005,M05,3.9,64004,1622086,1558082
Kentucky,2014,M10,5.0,99155,1982455,1883300
Tennessee,2002,M02,6.1,177957,2901588,2723631
Massachusetts,2008,M10,5.7,197602,3468089,3270487
Nebraska,2016,M08,3.2,32821,1013673,980852
Delaware,2005,M10,4.1,18112,438354,420242
North Dakota,2013,M09,2.2,9054,408635,399581
Connecticut,2015,M10,5.2,97683,1887067,1789384
Wisconsin,2012,M12,6.6,203779,3066357,2862578
New York,2011,M05,7.8,740067,9480448,8740381
South Dakota,2001,M05,2.9,11791,413575,401784
Connecticut,2014,M12,5.6,105535,1877140,1771605
New Mexico,2001,M12,4.8,41254,865855,824601
Mississippi,2005,M08,6.3,83310,1315623,1232313
Missouri,2005,M02,6.6,196544,2993935,2797391
Tennessee,2008,M06,6.8,210350,3092740,2882390
Louisiana,2012,M10,6.4,134352,2099216,1964864
Arkansas,2012,M12,7.4,97426,1311310,1213884
Massachusetts,2013,M10,6.2,217417,3495838,3278421
New Hampshire,2007,M01,4.2,30801,733894,703093
Oregon,2013,M07,8.0,153454,1928641,1775187
Wyoming,2005,M06,3.7,10303,281894,271591
Alabama,2005,M05,4.0,85864,2134052,2048188
Arizona,2001,M07,5.0,130486,2587051,2456565
Illinois,2001,M12,6.0,384241,6413543,6029302
Michigan,2010,M03,14.1,682910,4832571,4149661
Washington,2002,M09,6.7,206321,3098297,2891976
New Hampshire,2002,M04,4.4,30500,694111,663611
Colorado,2013,M08,6.5,181622,2790471,2608849
Michigan,2008,M11,8.2,398313,4870831,4472518
Mississippi,2009,M12,10.7,135679,1265409,1129730
New York,2000,M11,4.3,387271,9105062,8717791
Colorado,2005,M10,4.4,114175,2589468,2475293
New Mexico,2000,M06,5.6,47446,851414,803968
Arkansas,2004,M02,6.4,81916,1278549,1196633
South Carolina,2007,M02,6.1,128040,2106814,1978774
Maine,2006,M01,5.3,36584,690317,653733
Indiana,2010,M07,10.3,331800,3216769,2884969
Washington,2010,M12,9.6,333850,3465942,3132092
Minnesota,2000,M11,3.0,85736,2835486,2749750
Rhode Island,2004,M04,5.4,29733,554124,524391
North Carolina,2011,M02,10.6,486533,4587831,4101298
Pennsylvania,2015,M09,4.8,309495,6400395,6090900
Kansas,2007,M03,4.3,62746,1471907,1409161
Delaware,2011,M09,7.3,32277,440751,408474
Utah,2014,M11,3.2,45903,1442004,1396101
Georgia,2016,M04,5.0,245777,4880700,4634923
New York,2007,M09,4.5,427843,9506144,9078301
Alaska,2003,M04,8.2,26769,326570,299801
Missouri,2011,M09,8.1,247831,3043821,2795990
Alaska,2013,M07,6.2,23445,375567,352122
Iowa,2014,M10,3.7,63586,1713261,1649675
Georgia,2006,M02,4.9,229282,4644908,4415626
Maryland,2002,M09,4.0,115807,2870133,2754326
New Mexico,2013,M10,6.9,63324,923863,860539
Arizona,2016,M10,5.1,167206,3264008,3096802
Kentucky,2003,M05,6.2,122130,1964658,1842528
Montana,2010,M03,8.4,41568,497483,455915
Louisiana,2014,M06,7.0,152910,2180266,2027356
South Carolina,2016,M01,5.6,126284,2265096,2138812
New Mexico,2007,M06,4.4,41725,941297,899572
Connecticut,2012,M08,8.8,167353,1898263,1730910
Rhode Island,2009,M09,10.7,60543,565400,504857
Tennessee,2004,M02,5.4,153546,2868765,2715219
North Carolina,2002,M10,6.0,250147,4184097,3933950
Washington,2013,M04,6.8,234146,3446803,3212657
Wyoming,2005,M01,4.4,11990,271686,259696
Oregon,2002,M12,7.3,133453,1826311,1692858
Oregon,2016,M05,4.6,94466,2043391,1948925
Wisconsin,2012,M07,7.3,228075,3116391,2888316
Pennsylvania,2002,M02,6.2,382270,6193722,5811452
Colorado,2012,M02,8.7,237694,2745094,2507400
Louisiana,2007,M01,4.9,96848,1985431,1888583
New Mexico,2016,M04,6.2,57581,921721,864140
Maine,2009,M02,8.9,61444,689866,628422
Kansas,2001,M09,4.2,57835,1383775,1325940
North Dakota,2009,M07,3.9,14496,375651,361155
Delaware,2001,M03,3.8,16212,422775,406563
Colorado,2001,M05,3.1,72401,2359945,2287544
Alaska,2004,M12,7.3,24663,337401,312738
Texas,2002,M04,6.2,659628,10692377,10032749
New Hampshire,2004,M04,3.8,26864,707550,680686
Arkansas,2003,M04,5.7,71773,1266451,1194678
Montana,2012,M08,5.4,27774,515759,487985
Rhode Island,2004,M12,4.5,25279,559895,534616
North Dakota,2007,M11,2.6,9606,364134,354528
South Carolina,2007,M08,5.7,121989,2137864,2015875
Indiana,2008,M03,5.4,173428,3201437,3028009
West Virginia,2015,M10,5.6,44157,783633,739476
Oklahoma,2009,M10,6.9,121730,1767290,1645560
New Mexico,2004,M01,6.1,54424,891283,836859
Maine,2003,M05,4.8,32802,677026,644224
Massachusetts,2014,M05,5.6,197629,3525196,3327567
West Virginia,2007,M04,4.6,37178,807768,770590
Tennessee,2011,M10,8.3,259293,3130351,2871058
Minnesota,2008,M12,6.6,192110,2932846,2740736
Ohio,2001,M08,4.3,252686,5840436,5587750
Oklahoma,2001,M04,2.8,46608,1663369,1616761
Wisconsin,2016,M08,4.0,125875,3144447,3018572
Texas,2002,M05,6.1,654192,10697823,10043631
Texas,2016,M06,5.0,662948,13319665,12656717
Ohio,2000,M01,4.8,272315,5732318,5460003
Arizona,2005,M10,4.5,131986,2926199,2794213
Vermont,2002,M04,4.2,14327,338932,324605
Maine,2003,M04,5.3,36109,675222,639113
Kansas,2012,M02,6.3,92793,1481841,1389048
Wisconsin,2007,M05,4.7,143012,3068194,2925182
California,2015,M06,6.3,1185354,18922471,17737117
Puerto Rico,2007,M09,11.3,153265,1355205,1201940
Nevada,2012,M06,11.3,156200,1379448,1223248
Maryland,2002,M08,4.4,125913,2888772,2762859
Wyoming,2000,M09,3.4,9015,267506,258491
Minnesota,2012,M05,5.3,155240,2941448,2786208
North Dakota,2007,M01,3.9,13962,360473,346511
Puerto Rico,2002,M03,12.3,163023,1327237,1164214
Iowa,2009,M10,6.0,101904,1685937,1584033
West Virginia,2003,M01,6.8,53163,783691,730528
Oklahoma,2005,M01,5.1,85618,1677921,1592303
Arizona,2014,M08,7.3,226068,3100163,2874095
Missouri,2009,M04,8.2,248835,3045092,2796257
Alabama,2006,M10,3.6,79073,2182591,2103518
Montana,2006,M12,3.1,15259,490044,474785
New Mexico,2013,M09,6.9,63083,919530,856447
Ohio,2009,M06,10.9,653121,5982882,5329761
New Jersey,2014,M05,6.5,293501,4505141,4211640
Texas,2005,M04,5.2,572930,11052888,10479958
California,2000,M07,5.3,893996,16933223,16039227
Michigan,2013,M02,9.4,440303,4684336,4244033
Washington,2015,M04,5.2,183330,3520607,3337277
South Dakota,2013,M05,3.6,15976,445350,429374
New Hampshire,2013,M10,4.6,33866,738401,704535
South Dakota,2003,M08,3.4,14601,429725,415124
Maine,2008,M02,5.8,39979,692658,652679
Texas,2006,M01,5.3,590476,11186941,10596465
North Dakota,2012,M10,2.4,9426,400801,391375
Utah,2004,M02,5.7,68631,1212126,1143495
South Carolina,2013,M02,8.6,186963,2175345,1988382
Michigan,2002,M05,6.1,306532,5024641,4718109
Tennessee,2016,M11,4.7,148866,3157185,3008319
Alaska,2000,M10,5.8,18420,317055,298635
Puerto Rico,2000,M04,10.0,129204,1288457,1159253
Florida,2005,M02,4.1,352407,8538416,8186009
Utah,2006,M10,2.4,31355,1333876,1302521
Arizona,2011,M04,9.2,278280,3033931,2755651
Georgia,2005,M01,5.3,239194,4495374,4256180
Wisconsin,2004,M01,6.0,182123,3029359,2847236
Louisiana,2003,M02,6.1,121270,1994792,1873522
District of Columbia,2012,M01,10.1,35548,353006,317458
New Mexico,2006,M04,3.9,35757,919932,884175
Washington,2004,M07,5.9,191306,3224262,3032956
North Carolina,2006,M07,5.2,236655,4512692,4276037
Ohio,2010,M06,10.2,598568,5887154,5288586
Ohio,2005,M09,5.7,334329,5909203,5574874
Connecticut,2004,M02,5.6,97930,1759176,1661246
District of Columbia,2002,M12,6.3,19012,301879,282867
Mississippi,2001,M07,5.5,71493,1300880,1229387
Wisconsin,2000,M08,3.5,104026,2993932,2889906
Delaware,2008,M10,5.8,25736,445952,420216
Ohio,2015,M08,4.4,250912,5708823,5457911
District of Columbia,2013,M01,9.1,34065,373758,339693
Rhode Island,2006,M10,4.2,24162,573977,549815
Texas,2015,M09,4.5,583360,13033011,12449651
Kansas,2009,M05,6.9,105293,1519240,1413947
Missouri,2002,M05,5.1,154096,3002454,2848358
Delaware,2000,M08,3.9,16130,418141,402011
Maine,2008,M07,5.1,36928,720508,683580
Oklahoma,2016,M01,4.8,87307,1823746,1736439
Alabama,2014,M03,7.5,162263,2172369,2010106
Hawaii,2006,M09,2.6,16586,636466,619880
New York,2016,M02,5.3,511796,9638879,9127083
Minnesota,2007,M06,4.6,134480,2930465,2795985
Maine,2006,M11,4.5,31426,701912,670486
Georgia,2013,M08,8.3,392021,4741520,4349499
Nebraska,2015,M02,3.2,31576,999992,968416
Florida,2002,M06,5.9,480905,8128877,7647972
Alabama,2010,M01,12.3,263375,2135155,1871780
Maryland,2011,M05,7.1,219827,3086858,2867031
Maine,2016,M06,3.8,26416,702058,675642
Texas,2007,M04,4.0,448557,11349881,10901324
Montana,2007,M07,3.4,17341,514308,496967
Florida,2013,M05,7.2,684713,9518411,8833698
Utah,2010,M06,8.2,112133,1366010,1253877
Illinois,2004,M03,6.7,423385,6285335,5861950
Kentucky,2010,M04,10.0,205656,2059957,1854301
Maryland,2012,M01,7.4,227026,3086546,2859520
New York,2003,M08,6.2,576628,9292897,8716269
Maine,2000,M02,4.4,29713,671445,641732
District of Columbia,2014,M10,7.7,29702,383605,353903
Illinois,2010,M12,9.3,607035,6557154,5950119
Maryland,2014,M07,6.2,196595,3179237,2982642
Washington,2001,M10,6.1,186709,3038118,2851409
Georgia,2003,M03,4.8,212328,4384407,4172079
Illinois,2007,M02,5.2,339402,6578968,6239566
Wisconsin,2006,M03,5.6,169851,3030820,2860969
Florida,2001,M06,4.5,362512,8065438,7702926
Alabama,2002,M07,6.2,130722,2106827,1976105
Mississippi,2002,M12,6.6,85644,1297415,1211771
New Hampshire,2001,M11,3.9,27090,696432,669342
Missouri,2007,M07,5.5,168127,3067356,2899229
New Hampshire,2014,M11,3.8,28139,739037,710898
West Virginia,2001,M02,6.2,50317,808893,758576
Virginia,2002,M04,4.2,154227,3712963,3558736
Maryland,2013,M01,7.4,230389,3118152,2887763
Oklahoma,2007,M02,4.6,78766,1710992,1632226
Alabama,2000,M08,5.0,106446,2131694,2025248
California,2012,M10,9.7,1802219,18650563,16848344
Minnesota,2012,M06,5.8,171864,2967698,2795834
Kansas,2002,M07,5.5,79366,1437630,1358264
Michigan,2015,M08,5.2,250553,4773194,4522641
Montana,2016,M06,4.2,22468,534086,511618
District of Columbia,2001,M11,6.6,20288,307658,287370
New York,2013,M02,8.7,832423,9596421,8763998
Missouri,2016,M02,4.9,151362,3104593,2953231
North Carolina,2000,M02,3.8,155617,4101471,3945854
Wyoming,2016,M03,6.0,18172,301721,283549
Washington,2012,M06,8.2,286918,3495013,3208095
Massachusetts,2011,M09,7.1,246474,3456921,3210447
Pennsylvania,2006,M05,4.6,288027,6276417,5988390
Louisiana,2007,M03,4.1,81352,2008051,1926699
Vermont,2005,M01,4.2,14672,346156,331484
New Mexico,2000,M05,4.8,40130,838586,798456
Idaho,2004,M03,6.1,42141,693590,651449
Mississippi,2005,M11,8.7,114346,1312354,1198008
Idaho,2004,M02,6.2,43165,690730,647565
Kentucky,2012,M08,8.2,168447,2053516,1885069
Nebraska,2009,M02,4.5,44794,985400,940606
Texas,2007,M12,4.2,483652,11533207,11049555
Minnesota,2000,M05,2.8,78159,2804383,2726224
Massachusetts,2012,M08,6.6,231745,3524230,3292485
South Carolina,2006,M08,6.8,144597,2127674,1983077
Utah,2010,M01,8.4,113530,1352064,1238534
Alaska,2000,M09,5.6,17796,319338,301542
Hawaii,2010,M07,7.1,46816,656749,609933
District of Columbia,2009,M09,10.1,33749,334990,301241
Vermont,2007,M02,4.5,16101,354531,338430
Idaho,2001,M10,4.5,30859,683189,652330
District of Columbia,2004,M05,7.4,22835,306965,284130
South Dakota,2009,M10,4.5,19925,443399,423474
Alabama,2007,M04,3.3,70124,2156839,2086715
Connecticut,2013,M10,7.2,135051,1864339,1729288
Texas,2001,M07,5.2,549574,10582558,10032984
Tennessee,2000,M06,4.1,116671,2872974,2756303
Louisiana,2010,M10,8.1,169437,2099750,1930313
North Carolina,2007,M06,4.9,220499,4543831,4323332
Mississippi,2013,M09,8.2,103707,1262572,1158865
Rhode Island,2004,M01,6.3,34896,556522,521626
South Dakota,2008,M09,2.9,12976,445047,432071
Mississippi,2000,M06,6.1,81949,1340873,1258924
Colorado,2007,M02,4.1,107077,2627904,2520827
North Carolina,2010,M09,10.0,459133,4611717,4152584
New Jersey,2012,M04,9.2,419112,4564459,4145347
Maine,2002,M02,4.9,32460,660987,628527
Illinois,2014,M07,7.3,479310,6595678,6116368
New Hampshire,2006,M12,3.4,24761,733410,708649
Michigan,2006,M05,6.8,348163,5087509,4739346
Delaware,2011,M11,6.7,29978,445769,415791
New York,2011,M11,8.2,779975,9527167,8747192
Colorado,2001,M07,3.8,91170,2415401,2324231
Puerto Rico,2003,M04,12.3,168077,1364717,1196640
Illinois,2005,M02,6.6,418675,6338478,5919803
West Virginia,2003,M03,6.7,52716,781707,728991
Oklahoma,2005,M03,4.7,79571,1686205,1606634
New Mexico,2005,M04,5.0,45979,912251,866272
Alabama,2016,M08,6.2,134754,2168460,2033706
Iowa,2007,M08,3.4,57163,1656958,1599795
New Hampshire,2004,M05,3.6,25666,711157,685491
Pennsylvania,2011,M02,8.3,527221,6326336,5799115
Virginia,2012,M01,6.6,278300,4192056,3913756
Delaware,2007,M07,3.4,15196,447943,432747
Tennessee,2003,M12,5.2,150433,2895881,2745448
New Jersey,2004,M09,4.4,188179,4304711,4116532
Massachusetts,2014,M07,6.1,219212,3607503,3388291
Montana,2014,M03,5.7,28904,510009,481105
Maryland,2008,M12,5.4,162857,3013673,2850816
North Carolina,2004,M06,5.9,251055,4275331,4024276
Michigan,2008,M09,7.9,385331,4895396,4510065
New Hampshire,2007,M07,3.3,25200,752289,727089
Washington,2013,M11,6.6,227403,3456247,3228844
Nevada,2011,M09,12.9,176949,1376196,1199247
Kansas,2016,M08,4.6,67296,1477686,1410390
Washington,2002,M11,7.3,225272,3089309,2864037
South Carolina,2009,M12,11.5,244006,2115013,1871007
Mississippi,2007,M06,6.7,87490,1310840,1223350
South Dakota,2005,M02,4.6,19368,424430,405062
New Hampshire,2005,M08,3.4,25365,736732,711367
Wisconsin,2004,M11,4.2,127174,3016273,2889099
Arkansas,2016,M04,3.6,48474,1343967,1295493
Colorado,2013,M09,6.1,171138,2788843,2617705
South Carolina,2004,M01,7.3,146215,1994283,1848068
Delaware,2008,M11,5.9,26140,446236,420096
Pennsylvania,2016,M02,5.6,361565,6444353,6082788
Maryland,2015,M05,5.1,162223,3150439,2988216
Virginia,2015,M05,4.7,199578,4263797,4064219
Colorado,2008,M03,4.6,124379,2692404,2568025
Florida,2000,M09,3.9,312109,7906738,7594629
Rhode Island,2005,M01,6.0,33266,558159,524893
Montana,2001,M12,4.6,21228,460081,438853
Montana,2010,M07,6.7,34310,511660,477350
Delaware,2013,M03,7.3,32376,441521,409145
Florida,2001,M05,3.9,315166,8041216,7726050
Nevada,2007,M02,4.4,57490,1319083,1261593
Hawaii,2000,M05,4.2,25201,605129,579928
Iowa,2016,M05,3.3,56466,1697251,1640785
Wisconsin,2001,M04,4.6,138213,2998584,2860371
Nevada,2008,M08,7.0,95415,1370614,1275199
Texas,2005,M05,5.2,575497,11059509,10484012
Montana,2007,M03,3.6,17713,494827,477114
Nebraska,2016,M09,3.1,31006,1003800,972794
California,2015,M05,6.1,1154906,18939627,17784721
Mississippi,2010,M07,10.8,145933,1345847,1199914
Delaware,2006,M08,3.6,15861,443900,428039
Louisiana,2014,M08,7.3,160337,2183542,2023205
Georgia,2006,M11,4.4,208314,4783391,4575077
New Mexico,2007,M08,3.7,34845,933545,898700
Vermont,2003,M12,3.8,13349,347241,333892
Virginia,2003,M01,4.6,171192,3728537,3557345
Montana,2014,M01,6.1,30851,507717,476866
New Mexico,2016,M12,6.3,58415,934596,876181
Arizona,2009,M08,11.0,344704,3147832,2803128
Indiana,2005,M08,5.2,167308,3221381,3054073
Ohio,2004,M01,6.9,403223,5807560,5404337
Alaska,2004,M04,7.8,25796,329940,304144
Texas,2002,M12,6.2,674628,10829829,10155201
Virginia,2003,M04,3.9,147848,3753838,3605990
New Mexico,2001,M01,5.3,44926,848879,803953
Vermont,2006,M04,3.8,13489,352190,338701
Louisiana,2008,M02,3.9,79791,2030719,1950928
Colorado,2003,M03,6.3,154933,2457084,2302151
Wyoming,2004,M02,4.5,12289,271267,258978
Utah,2011,M12,5.6,76295,1351729,1275434
Pennsylvania,2013,M02,8.2,527347,6431710,5904363
Maine,2015,M04,4.8,32302,676468,644166
North Dakota,2010,M11,3.2,12192,377660,365468
Missouri,2016,M11,3.7,114870,3091875,2977005
North Dakota,2014,M02,3.4,13880,406169,392289
Wyoming,2007,M08,2.5,7266,290133,282867
Vermont,2013,M05,4.2,14690,349300,334610
Pennsylvania,2010,M05,8.6,548349,6408274,5859925
Tennessee,2008,M09,6.9,211516,3054619,2843103
Connecticut,2006,M10,3.9,72332,1839775,1767443
Utah,2007,M03,2.5,34077,1342252,1308175
South Dakota,2007,M02,3.5,15432,435359,419927
Vermont,2016,M08,3.1,10916,348711,337795
New York,2010,M03,9.1,870834,9574286,8703452
Wyoming,2002,M06,3.9,10724,274380,263656
Arkansas,2008,M08,5.4,74633,1382459,1307826
Florida,2011,M07,10.7,995233,9336098,8340865
Oregon,2011,M02,10.4,206942,1983970,1777028
Indiana,2006,M09,4.6,148142,3222630,3074488
Nevada,2012,M11,10.3,141534,1378697,1237163
Tennessee,2000,M12,3.6,103271,2856183,2752912
Idaho,2000,M11,4.6,30761,662531,631770
Arizona,2014,M02,6.9,211424,3060686,2849262
Kansas,2012,M08,5.9,86568,1478953,1392385
Nebraska,2000,M02,3.1,28744,936937,908193
Iowa,2011,M10,5.0,82229,1658606,1576377
Virginia,2006,M09,3.1,123372,3985023,3861651
Rhode Island,2003,M08,5.4,30552,566711,536159
Maryland,2011,M07,7.5,234201,3143135,2908934
Arkansas,2006,M04,5.0,67730,1367078,1299348
Massachusetts,2001,M05,3.3,109682,3354359,3244677
Pennsylvania,2000,M09,3.8,232035,6089884,5857849
Missouri,2012,M07,7.5,228293,3056624,2828331
Ohio,2001,M02,4.3,245857,5773660,5527803
Minnesota,2009,M12,7.5,218596,2912110,2693514
Puerto Rico,2009,M03,14.9,193479,1295949,1102470
Missouri,2001,M05,3.9,116801,2999908,2883107
Nevada,2006,M08,4.0,52522,1297618,1245096
New Jersey,2003,M02,6.3,273941,4335513,4061572
California,2015,M08,6.1,1144460,18906815,17762355
Montana,2006,M09,2.7,13253,492109,478856
Wisconsin,2014,M11,4.5,139161,3090025,2950864
Minnesota,2004,M02,5.5,156169,2852912,2696743
Iowa,2001,M06,3.2,51859,1621742,1569883
Washington,2016,M09,5.1,185885,3666453,3480568
Maine,2007,M06,4.4,31430,708711,677281
Kentucky,2002,M12,5.6,109174,1944931,1835757
Ohio,2002,M06,6.0,355933,5900220,5544287
New Jersey,2009,M05,8.8,400221,4555142,4154921
Montana,2011,M10,6.1,30665,501154,470489
Nebraska,2014,M04,3.2,32802,1013654,980852
Minnesota,2010,M08,7.1,211035,2960013,2748978
North Dakota,2000,M02,3.8,12929,336825,323896
Delaware,2016,M12,3.9,18141,470318,452177
Delaware,2010,M10,8.0,34871,436040,401169
Hawaii,2001,M07,4.4,27127,617377,590250
Tennessee,2013,M05,7.8,242837,3096213,2853376
Vermont,2004,M09,3.2,11190,347389,336199
Montana,2005,M08,3.8,19066,495384,476318
South Carolina,2006,M12,6.0,127512,2115831,1988319
Kansas,2014,M09,4.2,61835,1487294,1425459
Texas,2004,M07,6.2,684628,11061245,10376617
Kentucky,2010,M11,9.7,199936,2059322,1859386
Michigan,2010,M01,14.4,694137,4805847,4111710
Minnesota,2015,M06,3.8,114881,3001916,2887035
Tennessee,2009,M03,10.9,333551,3059317,2725766
Illinois,2000,M03,4.6,300059,6511122,6211063
Kentucky,2014,M04,6.4,129653,2017748,1888095
Florida,2010,M06,11.0,1012445,9221234,8208789
Utah,2006,M09,2.5,32880,1327578,1294698
Iowa,2002,M06,4.0,65878,1658092,1592214
Louisiana,2014,M11,6.7,147902,2194948,2047046
Georgia,2006,M08,4.9,229887,4724022,4494135
Texas,2000,M12,3.5,363245,10443931,10080686
Pennsylvania,2004,M11,5.0,312158,6242267,5930109
Nebraska,2002,M02,4.0,38240,946766,908526
Wisconsin,2000,M06,3.9,118798,3023551,2904753
Kentucky,2013,M07,8.4,173227,2070502,1897275
Arkansas,2000,M04,4.0,50425,1263905,1213480
Nevada,2013,M10,8.9,122244,1378246,1256002
Virginia,2002,M11,4.0,149910,3714161,3564251
Florida,2002,M01,6.1,488815,7973167,7484352
Michigan,2012,M07,10.6,504181,4748308,4244127
Connecticut,2002,M07,4.7,85361,1808573,1723212
Connecticut,2005,M12,4.0,71883,1799735,1727852
Wisconsin,2014,M10,4.4,136285,3097880,2961595
Iowa,2007,M11,3.3,55220,1672142,1616922
New Jersey,2008,M07,5.6,256813,4575393,4318580
North Carolina,2016,M03,5.0,245221,4871358,4626137
Wisconsin,2010,M03,10.3,315938,3077035,2761097
Texas,2001,M05,4.4,462514,10473632,10011118
California,2008,M01,6.4,1158755,18002805,16844050
California,2003,M05,6.4,1101497,17193431,16091934
Arizona,2010,M10,10.0,308121,3073382,2765261
Connecticut,2005,M05,5.0,89549,1796658,1707109
Minnesota,2000,M06,3.1,86910,2831620,2744710
Indiana,2001,M04,3.7,114909,3132849,3017940
Iowa,2013,M02,5.6,92819,1658525,1565706
Puerto Rico,2013,M05,13.5,155952,1153692,997740
Wyoming,2012,M07,4.9,15333,311440,296107
Michigan,2011,M02,11.1,517444,4652155,4134711
California,2000,M06,5.0,847653,16891189,16043536
Arizona,2016,M08,5.8,186548,3243683,3057135
Florida,2009,M06,10.8,985114,9146433,8161319
Maine,2008,M06,5.0,35683,712777,677094
Arkansas,2015,M09,4.5,59937,1338033,1278096
Texas,2004,M02,6.2,672619,10923681,10251062
Nebraska,2014,M12,2.8,28400,1002291,973891
South Carolina,2009,M11,11.3,239246,2124494,1885248
Wisconsin,2003,M06,6.2,192305,3104642,2912337
Arkansas,2010,M03,8.3,111767,1339373,1227606
West Virginia,2013,M10,6.2,49348,797058,747710
Oklahoma,2011,M10,5.9,104865,1789814,1684949
Florida,2012,M08,8.8,829830,9390314,8560484
Nevada,2016,M02,6.2,88608,1422269,1333661
Alabama,2011,M08,10.0,219374,2202727,1983353
Wisconsin,2004,M12,4.4,130754,3003970,2873216
New York,2008,M08,5.5,541033,9760437,9219404
Montana,2014,M10,4.0,20559,511890,491331
Idaho,2000,M03,5.6,36190,651686,615496
Minnesota,2005,M03,5.0,142521,2860612,2718091
Tennessee,2008,M12,8.1,247985,3053581,2805596
Pennsylvania,2014,M10,5.0,321086,6400398,6079312
Florida,2003,M02,5.2,421886,8136489,7714603
Utah,2014,M01,4.4,62823,1418802,1355979
South Carolina,2002,M10,5.6,110060,1959166,1849106
Utah,2007,M11,2.3,32057,1373350,1341293
Montana,2016,M01,5.3,27530,518896,491366
Rhode Island,2001,M02,4.9,26664,541544,514880
Wisconsin,2000,M09,3.0,88010,2963536,2875526
Ohio,2001,M12,5.1,295114,5829819,5534705
Alabama,2003,M09,6.0,126119,2114197,1988078
Michigan,2000,M11,3.4,176710,5156577,4979867
Wyoming,2008,M12,3.7,10963,294792,283829
New Jersey,2012,M11,9.0,413892,4586509,4172617
Wisconsin,2007,M04,5.2,160796,3067071,2906275
Alaska,2003,M10,7.2,23941,330232,306291
Mississippi,2004,M06,6.8,90523,1326124,1235601
North Dakota,2006,M11,3.0,10990,361709,350719
Illinois,2001,M09,5.0,322954,6415595,6092641
Idaho,2007,M10,2.5,18910,753930,735020
Maine,2011,M09,7.0,48628,699186,650558
Maryland,2015,M04,4.8,151376,3123266,2971890
Oklahoma,2016,M04,4.5,82586,1824356,1741770
Louisiana,2013,M09,6.4,135116,2111064,1975948
New Mexico,2007,M12,3.5,33068,943459,910391
Utah,2006,M11,2.1,28646,1336865,1308219
North Carolina,2015,M06,6.2,295730,4800097,4504367
Hawaii,2013,M08,4.7,30342,649592,619250
Virginia,2012,M08,6.2,262465,4210706,3948241
New York,2011,M07,8.4,802883,9582947,8780064
Pennsylvania,2007,M08,4.5,288538,6393372,6104834
Colorado,2001,M11,4.9,118779,2417407,2298628
South Carolina,2008,M05,5.8,125026,2145796,2020770
Rhode Island,2016,M01,6.5,35567,549590,514023
Connecticut,2014,M09,6.2,117082,1881921,1764839
Missouri,2005,M05,5.3,159957,3015380,2855423
Mississippi,2008,M06,7.1,94221,1322631,1228410
Alabama,2015,M02,6.2,133208,2136284,2003076
West Virginia,2010,M09,8.1,66268,816165,749897
Oklahoma,2012,M09,5.1,92980,1812760,1719780
Kentucky,2009,M09,10.1,207607,2052449,1844842
Indiana,2003,M04,5.0,157346,3175036,3017690
Minnesota,2016,M04,3.7,111721,2991122,2879401
Minnesota,2001,M07,3.5,101579,2873156,2771577
Massachusetts,2012,M11,6.3,219777,3498042,3278265
North Carolina,2007,M01,5.1,226854,4471294,4244440
Ohio,2011,M04,8.5,489517,5746865,5257348
Michigan,2009,M02,12.8,621595,4874357,4252762
Iowa,2005,M12,4.4,72235,1640329,1568094
Utah,2000,M10,3.2,37375,1154451,1117076
Rhode Island,2002,M08,5.1,28375,556907,528532
Maryland,2008,M05,3.8,113407,2990787,2877380
Oregon,2014,M09,6.1,119766,1956730,1836964
Ohio,2006,M12,5.2,310640,5989425,5678785
Pennsylvania,2001,M11,5.1,313414,6182854,5869440
Oregon,2003,M05,8.1,148999,1839460,1690461
Iowa,2002,M05,3.5,57372,1638416,1581044
Nebraska,2005,M09,3.4,33244,964315,931071
Wyoming,2015,M02,4.4,13218,302822,289604
Arizona,2013,M09,7.9,241125,3061408,2820283
Wyoming,2008,M03,3.4,9770,289456,279686
California,2004,M06,6.4,1110874,17390009,16279135
Ohio,2014,M10,4.9,281296,5735676,5454380
North Carolina,2012,M06,9.7,454476,4702503,4248027
Utah,2013,M06,5.0,71335,1417514,1346179
Florida,2001,M02,3.7,297322,7979168,7681846
Maryland,2006,M02,4.0,116110,2919294,2803184
Florida,2012,M04,8.1,757997,9310788,8552791
Ohio,2004,M07,6.4,381998,5953698,5571700
Ohio,2004,M03,6.7,393461,5836951,5443490
Idaho,2001,M09,4.4,30263,681616,651353
Mississippi,2015,M06,7.2,92123,1286846,1194723
Delaware,2000,M05,3.4,13941,410092,396151
Puerto Rico,2010,M02,16.1,204413,1273544,1069131
Alaska,2012,M12,7.2,25938,361654,335716
New Hampshire,2014,M08,4.1,30641,746572,715931
Virginia,2006,M06,3.3,130684,4012608,3881924
Wyoming,2009,M01,5.2,15280,294670,279390
Maryland,2008,M04,3.2,96344,2969493,2873149
Mississippi,2001,M02,5.1,66560,1302705,1236145
South Dakota,2005,M08,3.6,15490,436286,420796
South Dakota,2012,M01,5.0,21855,433668,411813
Kentucky,2012,M01,9.0,183640,2031067,1847427
Wisconsin,2005,M04,4.8,143066,2991716,2848650
Illinois,2013,M04,8.6,559942,6506720,5946778
New Mexico,2002,M07,6.1,53817,883874,830057
North Carolina,2006,M02,5.0,218569,4344551,4125982
South Carolina,2015,M08,6.0,136531,2283898,2147367
Colorado,2009,M07,7.5,207672,2756823,2549151
Louisiana,2000,M01,5.5,110778,2017790,1907012
New Hampshire,2006,M09,3.2,23587,730558,706971
Colorado,2011,M08,8.1,222795,2752900,2530105
Nevada,2005,M07,4.3,52910,1233232,1180322
Iowa,2007,M02,4.5,73645,1650417,1576772
Nevada,2005,M03,4.1,49299,1203792,1154493
South Dakota,2014,M02,4.2,18465,442691,424226
Montana,2010,M01,8.4,41740,494428,452688
Illinois,2016,M06,6.0,393374,6610567,6217193
Arkansas,2005,M11,4.6,61778,1355485,1293707
Arkansas,2010,M11,7.9,107132,1355059,1247927
Alaska,2000,M04,6.7,21092,315055,293963
Virginia,2007,M04,2.7,107718,4006092,3898374
Kentucky,2005,M08,5.6,113234,2005621,1892387
Maine,2010,M03,9.2,63282,686827,623545
Colorado,2015,M03,4.6,128812,2814702,2685890
Wyoming,2011,M10,5.2,15985,307938,291953
Alaska,2007,M07,5.6,20409,361263,340854
Indiana,2000,M10,2.2,69358,3103481,3034123
District of Columbia,2013,M03,8.6,31996,373398,341402
Wyoming,2010,M05,6.5,19707,302103,282396
Idaho,2012,M04,7.6,58145,764402,706257
Rhode Island,2013,M05,9.1,49983,552025,502042
North Dakota,2010,M09,3.0,11314,379458,368144
New Hampshire,2010,M03,6.7,49474,739528,690054
Utah,2003,M02,6.3,74711,1187386,1112675
Wisconsin,2015,M12,4.1,127324,3096798,2969474
Nevada,2008,M06,6.4,87047,1368293,1281246
Minnesota,2005,M11,3.7,106564,2891224,2784660
South Dakota,2006,M05,2.9,12575,433955,421380
Arizona,2002,M08,6.7,180738,2698294,2517556
Maine,2011,M10,7.0,48820,702087,653267
Iowa,2013,M08,4.6,76918,1685321,1608403
New York,2005,M04,4.8,448980,9383123,8934143
California,2008,M05,6.4,1163777,18096010,16932233
Tennessee,2003,M05,5.3,154497,2912788,2758291
Maine,2003,M03,5.7,38069,672846,634777
Arizona,2006,M07,4.6,138910,2998656,2859746
California,2009,M09,11.4,2079035,18159540,16080505
Virginia,2010,M02,7.9,324113,4093421,3769308
Utah,2013,M04,4.6,63909,1394533,1330624
Rhode Island,2016,M09,4.9,27069,552409,525340
Connecticut,2014,M01,7.6,140377,1859058,1718681
Alaska,2007,M02,7.3,25234,346089,320855
North Carolina,2004,M02,6.0,255398,4232362,3976964
Arizona,2005,M05,4.4,127329,2861415,2734086
Pennsylvania,2016,M07,6.0,395273,6572241,6176968
Massachusetts,2005,M01,5.6,186373,3355846,3169473
North Dakota,2006,M03,3.9,13889,355889,342000
Texas,2001,M01,4.3,450622,10450827,10000205
Ohio,2001,M11,4.8,279065,5839654,5560589
Nevada,2011,M06,13.2,181084,1373654,1192570
Delaware,2008,M09,5.4,24029,442557,418528
Oregon,2004,M11,6.6,121996,1840273,1718277
Puerto Rico,2002,M01,11.4,147226,1293401,1146175
Georgia,2003,M01,5.2,227646,4368695,4141049
Iowa,2005,M06,4.2,68914,1641396,1572482
New York,2000,M09,4.3,387741,9056570,8668829
Wisconsin,2006,M01,5.2,157201,3010250,2853049
Rhode Island,2008,M07,8.1,46955,577012,530057
Missouri,2008,M09,6.4,192780,3027435,2834655
New York,2001,M05,4.0,362719,9068221,8705502
Arkansas,2013,M08,7.2,94542,1309160,1214618
North Dakota,2009,M12,4.1,15063,365263,350200
Oregon,2014,M08,6.8,133711,1967479,1833768
Arkansas,2005,M02,6.0,78835,1319648,1240813
Wisconsin,2004,M08,4.6,139364,3053606,2914242
Nebraska,2009,M07,4.9,49541,1008451,958910
Nevada,2001,M02,4.9,54495,1102179,1047684
Georgia,2005,M08,5.3,242841,4604581,4361740
Virginia,2004,M07,4.0,152386,3854196,3701810
Oregon,2008,M07,6.3,123851,1976363,1852512
Ohio,2011,M08,8.9,516746,5829079,5312333
Puerto Rico,2003,M05,12.0,165655,1375365,1209710
New Mexico,2014,M08,6.9,63526,922267,858741
Iowa,2014,M12,4.1,69874,1700549,1630675
Iowa,2009,M06,6.6,112895,1705752,1592857
California,2003,M04,6.7,1153757,17242301,16088544
Delaware,2012,M08,7.4,32899,447475,414576
Utah,2002,M02,6.0,70386,1180255,1109869
Nebraska,2005,M12,3.6,34570,967971,933401
Texas,2011,M02,8.0,984454,12374880,11390426
Wyoming,2015,M11,4.5,13669,302892,289223
Tennessee,2005,M03,6.0,172476,2859083,2686607
Wyoming,2008,M11,3.2,9449,295690,286241
Massachusetts,2002,M08,5.3,184127,3479408,3295281
Nebraska,2011,M01,5.1,50067,987363,937296
New Mexico,2016,M07,7.5,69792,932188,862396
South Dakota,2006,M10,2.8,12238,438534,426296
Washington,2006,M03,5.3,175481,3302267,3126786
Indiana,2004,M06,5.3,169789,3197418,3027629
Illinois,2015,M07,6.2,405709,6594909,6189200
Hawaii,2009,M01,6.4,40758,632529,591771
Alabama,2012,M07,9.0,197589,2195941,1998352
Vermont,2010,M12,5.7,20371,358694,338323
Iowa,2010,M06,5.9,98881,1689893,1591012
New York,2005,M06,4.8,460307,9515176,9054869
New Hampshire,2009,M11,6.0,44386,738532,694146
Rhode Island,2012,M03,11.4,63248,554755,491507
Iowa,2012,M09,4.6,75443,1647470,1572027
Alabama,2008,M08,6.2,135258,2180770,2045512
Vermont,2006,M07,3.6,12978,361938,348960
Florida,2012,M01,9.0,835499,9238253,8402754
Arizona,2007,M02,3.7,111686,3019018,2907332
South Dakota,2012,M12,4.1,17870,440083,422213
California,2000,M04,4.8,805179,16782321,15977142
Maine,2012,M06,7.3,51713,712513,660800
Oregon,2013,M02,9.1,172454,1896415,1723961
Virginia,2015,M11,3.9,162805,4172516,4009711
North Dakota,2002,M03,4.5,15212,336879,321667
Maryland,2016,M02,4.7,147351,3138625,2991274
Arkansas,2006,M03,5.1,70085,1362259,1292174
Minnesota,2008,M06,5.4,157796,2947486,2789690
Washington,2006,M08,5.0,166851,3337655,3170804
Michigan,2011,M08,10.6,502344,4724529,4222185
North Carolina,2012,M01,10.0,461382,4607262,4145880
Puerto Rico,2004,M09,9.8,132195,1355743,1223548
Maryland,2011,M06,7.6,237604,3120672,2883068
New York,2001,M01,4.8,441925,9145739,8703814
Wisconsin,2004,M05,4.9,147707,3020146,2872439
Missouri,2009,M03,9.3,284027,3038294,2754267
Minnesota,2001,M03,4.3,120898,2836760,2715862
Texas,2015,M12,4.2,552984,13093682,12540698
California,2008,M06,7.0,1273683,18196508,16922825
New York,2002,M11,6.1,569423,9263228,8693805
New Mexico,2014,M09,6.5,60070,919670,859600
Indiana,2007,M06,4.5,146858,3233860,3087002
Colorado,2000,M02,3.1,71931,2346818,2274887
Puerto Rico,2006,M07,11.9,166531,1401807,1235276
New Hampshire,2010,M11,5.3,39207,733994,694787
Louisiana,2008,M08,5.5,116018,2110235,1994217
Maine,2002,M04,4.5,30247,665154,634907
District of Columbia,2003,M05,6.5,19820,304710,284890
Maine,2008,M12,6.8,47266,695457,648191
Missouri,2012,M04,6.5,196485,3015238,2818753
California,2012,M05,10.2,1878836,18476530,16597694
Virginia,2000,M10,1.8,65501,3601075,3535574
Alabama,2007,M01,4.3,93046,2169298,2076252
Arkansas,2013,M03,7.4,96761,1307949,1211188
North Dakota,2012,M12,3.1,12255,397448,385193
Maryland,2008,M06,4.3,130677,3027771,2897094
New York,2003,M11,6.3,586050,9250525,8664475
District of Columbia,2002,M07,6.6,20780,315074,294294
Virginia,2005,M02,4.0,153216,3818079,3664863
Washington,2007,M09,4.3,147847,3423234,3275387
Maryland,2002,M10,4.0,116392,2874252,2757860
Virginia,2011,M10,6.4,271547,4229622,3958075
Arizona,2016,M09,5.4,175080,3263107,3088027
Mississippi,2012,M06,9.8,131361,1336276,1204915
Minnesota,2007,M09,4.4,129433,2911415,2781982
New Jersey,2001,M11,4.8,206784,4317393,4110609
Missouri,2011,M10,7.6,232968,3048722,2815754
Tennessee,2011,M12,7.8,241584,3112452,2870868
Ohio,2007,M04,5.5,326114,5956950,5630836
Puerto Rico,2007,M04,10.1,141645,1406842,1265197
New Hampshire,2009,M07,6.3,47709,755903,708194
Texas,2000,M09,4.2,432010,10348083,9916073
Connecticut,2002,M02,3.9,68616,1746354,1677738
Indiana,2003,M08,5.4,174137,3197048,3022911
Minnesota,2016,M08,3.8,113799,3016796,2902997
Pennsylvania,2015,M10,4.8,305798,6402839,6097041
Oregon,2015,M02,6.2,120953,1936453,1815500
Washington,2005,M11,5.4,176702,3288970,3112268
North Carolina,2008,M01,5.3,239310,4504516,4265206
Hawaii,2005,M09,3.0,19139,628454,609315
Kentucky,2013,M02,8.8,181266,2057781,1876515
Nebraska,2004,M02,4.3,41615,961147,919532
New Hampshire,2013,M08,4.8,36003,750354,714351
West Virginia,2005,M05,4.9,38584,788607,750023
Oklahoma,2003,M05,5.7,96427,1688026,1591599
Wyoming,2012,M03,5.9,18020,306071,288051
New Mexico,2003,M05,5.6,49224,881525,832301
North Carolina,2009,M01,10.2,466462,4573819,4107357
Tennessee,2008,M01,5.9,179587,3035808,2856221
Kansas,2008,M03,4.4,65363,1484407,1419044
Delaware,2015,M11,4.2,19875,472395,452520
Michigan,2012,M12,8.7,405704,4677452,4271748
Delaware,2000,M11,3.3,13808,419329,405521
Ohio,2000,M03,4.4,256027,5769080,5513053
Mississippi,2003,M06,7.6,99573,1318252,1218679
Maine,2013,M01,8.2,56941,696915,639974
Illinois,2013,M11,8.3,544245,6527119,5982874
Vermont,2003,M06,4.2,14795,349775,334980
Maine,2000,M04,3.6,24151,673667,649516
Florida,2014,M05,6.3,605051,9625675,9020624
New York,2004,M07,5.8,552734,9529286,8976552
Rhode Island,2004,M09,4.5,25160,558280,533120
South Dakota,2008,M01,3.1,13586,436784,423198
Vermont,2007,M05,3.7,12833,351322,338489
Illinois,2009,M04,9.6,631093,6607688,5976595
Kentucky,2002,M08,5.4,104202,1938230,1834028
Wyoming,2002,M04,4.2,11267,266884,255617
Rhode Island,2009,M08,11.2,63800,571512,507712
Louisiana,2015,M02,6.5,139221,2153560,2014339
Missouri,2007,M12,5.4,161778,3020028,2858250
Washington,2006,M11,5.0,166208,3351324,3185116
Colorado,2015,M01,4.7,131996,2808092,2676096
Maine,2010,M08,7.2,51162,710588,659426
New Mexico,2015,M08,6.7,61690,922971,861281
Michigan,2001,M05,4.6,235787,5134188,4898401
Hawaii,2011,M12,6.4,41854,653392,611538
Maine,2015,M06,4.2,29155,693181,664026
Rhode Island,2014,M05,7.8,42864,552374,509510
Texas,2016,M02,4.4,581318,13185966,12604648
South Carolina,2015,M02,6.6,148656,2245385,2096729
Georgia,2006,M12,4.3,207219,4804054,4596835
Iowa,2014,M11,3.6,61145,1705221,1644076
Michigan,2008,M10,8.0,394583,4908621,4514038
Montana,2011,M08,6.3,32111,509842,477731
Ohio,2005,M05,5.7,332940,5882874,5549934
Indiana,2001,M12,5.2,164595,3144870,2980275
Tennessee,2004,M07,5.3,153931,2909923,2755992
Mississippi,2016,M11,5.0,64314,1281867,1217553
Kentucky,2011,M02,10.6,217010,2049745,1832735
Tennessee,2000,M10,3.6,101126,2833528,2732402
Pennsylvania,2005,M05,4.9,302882,6240900,5938018
Ohio,2008,M07,7.0,422622,6071104,5648482
Montana,2003,M02,5.3,24698,464446,439748
Florida,2005,M07,3.9,342810,8816766,8473956
North Dakota,2014,M12,2.6,10942,413150,402208
Georgia,2001,M05,3.4,143353,4238507,4095154
Illinois,2001,M10,5.3,340154,6421512,6081358
Alaska,2016,M02,7.5,26762,357339,330577
New York,2009,M11,8.5,813304,9565858,8752554
Alaska,2003,M09,6.9,22942,331794,308852
Maine,2000,M12,3.1,20831,670191,649360
Puerto Rico,2003,M07,12.4,167167,1350818,1183651
Arizona,2011,M01,10.0,302938,3039415,2736477
Wyoming,2013,M09,4.0,12221,306052,293831
Maine,2015,M03,5.4,36619,675726,639107
Alabama,2009,M07,11.8,256024,2178713,1922689
Alabama,2005,M02,5.4,115837,2130765,2014928
Nevada,2010,M01,13.5,182244,1348276,1166032
Washington,2010,M10,9.1,319498,3496906,3177408
District of Columbia,2007,M05,5.1,16348,318409,302061
Wisconsin,2000,M04,3.4,101386,2953493,2852107
Nebraska,2012,M01,4.5,45165,998519,953354
Mississippi,2014,M09,7.0,87373,1243138,1155765
Nebraska,2004,M04,3.6,34978,967674,932696
Arizona,2000,M03,3.9,98117,2502095,2403978
Indiana,2015,M12,4.6,151023,3293171,3142148
North Carolina,2013,M09,7.2,337624,4688979,4351355
Alabama,2011,M12,7.9,172004,2176155,2004151
Arkansas,2006,M01,5.5,73492,1341105,1267613
Vermont,2013,M07,4.5,15920,356280,340360
Kansas,2013,M06,5.8,86510,1504156,1417646
Delaware,2009,M02,8.2,36334,442064,405730
Texas,2008,M03,4.2,489116,11540874,11051758
Wyoming,2013,M07,4.2,13026,310830,297804
Indiana,2009,M07,10.5,338775,3226721,2887946
Hawaii,2013,M03,4.8,31209,644359,613150
South Dakota,2012,M08,4.1,18316,446868,428552
Vermont,2001,M12,3.4,11390,338862,327472
Alabama,2012,M05,7.8,170124,2178571,2008447
Utah,2003,M10,5.1,62061,1211156,1149095
California,2011,M08,11.9,2196059,18497557,16301498
Nebraska,2001,M03,3.2,30761,946576,915815
New Jersey,2007,M09,4.1,180229,4417217,4236988
Minnesota,2002,M08,4.0,116208,2874673,2758465
Ohio,2008,M09,6.5,385745,5961551,5575806
Nevada,2008,M09,7.2,98892,1368115,1269223
New York,2009,M10,8.7,830227,9588933,8758706
Massachusetts,2001,M07,3.9,132735,3432075,3299340
Connecticut,2011,M05,8.9,170615,1922502,1751887
Kentucky,2002,M11,5.5,106363,1945051,1838688
New Jersey,2001,M12,5.0,215345,4332584,4117239
Tennessee,2000,M05,3.5,99800,2828507,2728707
Pennsylvania,2005,M10,4.4,273418,6255420,5982002
Louisiana,2012,M03,7.2,148384,2060761,1912377
Kansas,2010,M06,7.1,107640,1517645,1410005
Colorado,2010,M09,8.4,230473,2736922,2506449
New Mexico,2007,M05,3.6,32946,926510,893564
Connecticut,2015,M03,6.2,116827,1883911,1767084
Michigan,2011,M12,9.0,419187,4659024,4239837
Arizona,2004,M07,5.4,151881,2807957,2656076
California,2003,M01,7.3,1262170,17255398,15993228
Minnesota,2007,M10,4.0,117397,2909345,2791948
Texas,2008,M12,5.5,641504,11752229,11110725
Wisconsin,2013,M01,7.9,240962,3057850,2816888
Alaska,2010,M05,7.8,28250,361477,333227
Vermont,2013,M12,3.8,13386,348754,335368
Nebraska,2008,M01,3.5,34533,976755,942222
Alabama,2011,M03,9.9,218776,2206650,1987874
Wisconsin,2015,M07,4.6,142987,3131648,2988661
Iowa,2008,M02,4.4,72685,1663954,1591269
Montana,2013,M07,5.0,26073,521955,495882
North Dakota,2012,M11,2.7,10923,397465,386542
Connecticut,2013,M12,6.7,125103,1859018,1733915
District of Columbia,2003,M11,6.8,20829,305108,284279
Alaska,2002,M01,7.8,25012,319161,294149
Kansas,2011,M12,5.7,84491,1481762,1397271
Missouri,2010,M01,10.3,311956,3022843,2710887
Iowa,2014,M06,4.3,73624,1719093,1645469
New Mexico,2008,M11,4.9,46643,952723,906080
Georgia,2010,M08,10.8,504714,4692284,4187570
South Carolina,2000,M09,3.7,74132,1983182,1909050
Iowa,2009,M12,6.5,109007,1669581,1560574
South Dakota,2000,M10,2.0,8365,408759,400394
Washington,2005,M08,5.3,174300,3285499,3111199
Maine,2015,M12,3.8,25847,676495,650648
Massachusetts,2007,M02,5.2,177319,3399557,3222238
New York,2002,M05,5.9,541849,9235340,8693491
New Hampshire,2012,M07,5.5,41357,754998,713641
Minnesota,2011,M02,7.5,218025,2921487,2703462
Delaware,2012,M06,7.4,33459,449789,416330
Michigan,2004,M12,7.0,353460,5070170,4716710
Washington,2012,M04,8.0,277566,3459777,3182211
New York,2013,M06,7.8,762896,9734177,8971281
New Jersey,2016,M12,4.2,187578,4491251,4303673
North Dakota,2014,M03,3.3,13669,408343,394674
Nebraska,2006,M12,2.9,27794,968498,940704
Illinois,2004,M05,6.0,374681,6282019,5907338
Indiana,2008,M12,8.1,261955,3223460,2961505
Alabama,2005,M10,4.2,91482,2170156,2078674
Alabama,2000,M01,5.1,108551,2132813,2024262
Montana,2001,M01,5.8,26858,462655,435797
Arizona,2007,M11,4.0,122313,3065794,2943481
Florida,2009,M01,9.0,822526,9093478,8270952
New York,2005,M01,5.7,530785,9356967,8826182
Idaho,2008,M01,4.1,30657,740220,709563
Tennessee,2016,M12,4.9,155435,3156140,3000705
Tennessee,2007,M07,4.6,141290,3096313,2955023
New Hampshire,2009,M05,6.4,47719,743768,696049
Florida,2008,M08,7.2,664209,9273966,8609757
Alabama,2007,M08,4.3,92639,2170686,2078047
Iowa,2008,M04,3.8,63413,1674819,1611406
Wyoming,2016,M12,5.0,14866,299114,284248
West Virginia,2016,M07,5.7,45427,791694,746267
Delaware,2015,M06,5.1,24229,470865,446636
New York,2003,M01,7.0,652893,9285743,8632850
South Carolina,2007,M04,5.2,109810,2116262,2006452
Iowa,2002,M10,3.5,57756,1641699,1583943
North Carolina,2005,M03,5.4,229853,4266717,4036864
New Mexico,2003,M07,6.5,58113,898815,840702
Virginia,2009,M09,6.9,280237,4089167,3808930
Indiana,2015,M06,4.8,159616,3312177,3152561
California,2007,M07,5.7,1023914,18005213,16981299
Washington,2003,M02,8.2,255517,3107413,2851896
Washington,2013,M07,6.9,240878,3491525,3250647
Texas,2016,M10,4.6,612866,13338725,12725859
Nevada,2001,M04,4.9,53803,1103440,1049637
New Jersey,2013,M04,8.2,373406,4533792,4160386
South Dakota,2003,M10,3.1,13115,424658,411543
Kentucky,2007,M07,5.5,111926,2047397,1935471
District of Columbia,2012,M09,8.9,32794,368334,335540
New York,2005,M07,5.1,486644,9612433,9125789
Alaska,2005,M11,6.9,23875,344073,320198
Colorado,2016,M07,3.4,98970,2916061,2817091
South Carolina,2005,M08,6.8,143232,2094925,1951693
Montana,2010,M04,7.5,37548,500180,462632
Maine,2010,M01,9.2,63326,685834,622508
Kansas,2016,M04,3.8,56154,1479812,1423658
North Carolina,2002,M05,6.6,275894,4201296,3925402
Louisiana,2015,M10,6.0,128275,2154313,2026038
Arizona,2000,M10,3.8,95167,2523151,2427984
Montana,2009,M09,6.0,29982,497733,467751
Missouri,2008,M05,5.6,168896,3029892,2860996
Arizona,2008,M08,7.2,226000,3127941,2901941
South Dakota,2008,M03,3.1,13676,442903,429227
Wyoming,2012,M12,5.2,15953,305084,289131
Pennsylvania,2003,M08,5.5,339826,6201517,5861691
Kentucky,2012,M04,7.5,153746,2046088,1892342
Florida,2013,M01,8.2,773099,9379428,8606329
Nevada,2016,M10,5.2,73890,1432972,1359082
North Carolina,2004,M04,5.4,228797,4238133,4009336
Pennsylvania,2009,M11,7.8,494767,6332737,5837970
Wyoming,2009,M04,6.8,20307,299650,279343
Pennsylvania,2011,M03,8.0,504851,6339889,5835038
Puerto Rico,2002,M10,12.0,157645,1311769,1154124
Iowa,2009,M03,7.0,118513,1691294,1572781
Kentucky,2016,M06,5.3,107207,2017049,1909842
Tennessee,2012,M01,8.3,256577,3076071,2819494
Kansas,2012,M03,6.1,89776,1479510,1389734
Vermont,2011,M09,5.2,18542,357025,338483
Rhode Island,2006,M08,5.0,28920,578707,549787
Tennessee,2004,M05,4.6,131761,2863173,2731412
Michigan,2013,M09,8.3,393186,4743208,4350022
Indiana,2015,M01,6.1,197636,3239153,3041517
Utah,2007,M08,2.8,38847,1371201,1332354
Oregon,2005,M07,6.1,114627,1867160,1752533
Utah,2001,M09,4.4,51044,1167952,1116908
South Carolina,2001,M04,4.5,88263,1951943,1863680
Utah,2009,M06,7.8,106663,1375649,1268986
Colorado,2007,M07,3.7,100942,2693557,2592615
Alaska,2014,M05,6.8,25067,367332,342265
Mississippi,2011,M06,10.9,148187,1360170,1211983
Maine,2007,M12,4.7,32821,698438,665617
Louisiana,2003,M12,5.4,109197,2007591,1898394
Arizona,2011,M12,8.5,258710,3026082,2767372
Maine,2011,M01,9.1,62628,689023,626395
New Hampshire,2002,M08,4.4,31636,713364,681728
North Dakota,2001,M05,2.4,8368,344650,336282
Indiana,2003,M01,5.5,174363,3159959,2985596
Minnesota,2016,M01,4.6,136200,2975603,2839403
Kansas,2001,M10,4.2,58853,1392109,1333256
Idaho,2005,M02,5.2,37674,719528,681854
Florida,2005,M09,3.7,325550,8833638,8508088
Maine,2007,M05,4.6,32118,694008,661890
Ohio,2002,M05,5.5,323019,5853103,5530084
Delaware,2004,M01,4.4,18328,417071,398743
Arkansas,2013,M11,6.6,85248,1296815,1211567
Florida,2000,M03,3.5,273276,7800137,7526861
Puerto Rico,2016,M06,10.8,119781,1108392,988611
District of Columbia,2016,M03,6.0,23501,391324,367823
Maine,2003,M06,4.8,33054,692542,659488
North Dakota,2005,M10,2.6,9113,356705,347592
New Hampshire,2015,M02,4.3,31427,738354,706927
Indiana,2000,M12,2.9,89804,3115697,3025893
Michigan,2008,M04,6.7,326460,4874313,4547853
California,2001,M12,6.1,1056823,17200689,16143866
Nevada,2009,M01,10.0,136289,1358979,1222690
Iowa,2006,M07,3.4,57562,1680778,1623216
Colorado,2014,M04,5.5,154158,2798034,2643876
North Dakota,2000,M10,2.0,6697,342415,335718
Mississippi,2003,M08,6.0,77514,1294328,1216814
Arkansas,2008,M09,5.4,74202,1379730,1305528
Michigan,2007,M03,7.0,353108,5015063,4661955
Nevada,2010,M11,13.6,185224,1363992,1178768
West Virginia,2014,M01,7.7,60245,786375,726130
Oklahoma,2008,M01,3.8,64955,1714716,1649761
North Carolina,2006,M04,4.5,196024,4395992,4199968
West Virginia,2004,M07,5.1,40847,793464,752617
Oklahoma,2002,M07,4.5,75673,1694637,1618964
Colorado,2000,M10,2.4,57053,2370436,2313383
Arizona,2015,M06,6.3,200488,3169400,2968912
Wisconsin,2014,M08,5.1,159101,3106267,2947166
Arkansas,2012,M08,7.5,100207,1340088,1239881
Georgia,2011,M08,10.6,506432,4763958,4257526
Louisiana,2015,M04,6.0,131017,2169689,2038672
Louisiana,2013,M08,6.9,146431,2117129,1970698
New Mexico,2004,M08,5.5,49523,902981,853458
Wyoming,2007,M01,3.5,9910,280655,270745
Puerto Rico,2010,M04,17.2,220762,1281091,1060329
Arizona,2010,M08,10.8,334974,3092955,2757981
Nevada,2005,M05,3.9,47555,1217175,1169620
Arkansas,2014,M11,5.3,69662,1314255,1244593
Oklahoma,2016,M12,4.6,83463,1821171,1737708
Tennessee,2013,M09,7.6,233068,3060596,2827528
Alabama,2013,M05,6.7,146488,2171580,2025092
New Hampshire,2006,M10,3.1,22773,731784,709011
Idaho,2003,M11,5.3,36465,688824,652359
Kansas,2016,M03,4.2,62200,1484973,1422773
Arizona,2004,M03,5.2,144266,2770944,2626678
Illinois,2002,M09,5.9,374188,6310014,5935826
Minnesota,2008,M09,5.4,157716,2933542,2775826
Utah,2000,M03,3.3,37542,1125742,1088200
Arkansas,2002,M02,6.1,76880,1255313,1178433
Kentucky,2010,M07,10.1,207355,2060118,1852763
Texas,2012,M03,6.8,859410,12600799,11741389
South Carolina,2016,M08,5.1,117129,2316553,2199424
Oregon,2012,M11,8.3,160453,1930703,1770250
Alaska,2002,M11,7.4,24112,325704,301592
Ohio,2016,M06,5.0,286907,5754452,5467545
Connecticut,2001,M07,3.5,63406,1795533,1732127
Hawaii,2009,M03,7.0,44273,632017,587744
North Carolina,2005,M04,5.1,220817,4297599,4076782
Kansas,2011,M08,6.6,98912,1488351,1389439
Alabama,2006,M08,4.4,96477,2175990,2079513
Florida,2002,M04,5.5,443774,8053556,7609782
Connecticut,2016,M05,5.1,97111,1895569,1798458
South Carolina,2011,M05,10.3,225692,2186040,1960348
Colorado,2012,M12,7.3,202882,2761281,2558399
Montana,2004,M11,4.4,21097,479172,458075
North Dakota,2001,M12,3.4,11398,334496,323098
Kansas,2005,M01,5.8,84118,1461771,1377653
Wisconsin,2013,M11,6.0,183052,3076073,2893021
South Dakota,2015,M11,2.6,11943,450900,438957
Missouri,2009,M01,8.9,268369,3027141,2758772
Colorado,2003,M04,5.9,145529,2463224,2317695
Oregon,2004,M10,6.5,119549,1838257,1718708
Alaska,2009,M07,7.1,26347,370991,344644
Arkansas,2007,M10,4.7,64618,1366867,1302249
Oregon,2002,M08,7.0,130269,1857580,1727311
Louisiana,2000,M03,4.9,100421,2035606,1935185
Michigan,2010,M04,12.9,621440,4824935,4203495
Arizona,2002,M09,6.2,169101,2711903,2542802
Connecticut,2003,M03,5.6,99907,1777287,1677380
Ohio,2010,M04,10.4,611367,5872185,5260818
Missouri,2012,M02,7.9,239946,3018508,2778562
Wisconsin,2009,M01,7.7,238239,3085078,2846839
New York,2015,M10,4.7,448791,9552499,9103708
Idaho,2002,M09,4.6,31346,683826,652480
Kentucky,2012,M03,8.5,173600,2053105,1879505
Alabama,2007,M03,3.8,81789,2176156,2094367
North Dakota,2004,M07,3.2,11415,361688,350273
Georgia,2000,M09,3.5,146555,4209664,4063109
Utah,2010,M05,7.8,105612,1356287,1250675
Vermont,2016,M11,2.9,10072,344383,334311
Louisiana,2009,M08,7.4,154621,2076336,1921715
Idaho,2011,M01,10.1,76081,756795,680714
Utah,2016,M10,3.1,47409,1527871,1480462
South Dakota,2015,M02,3.8,17121,445573,428452
Massachusetts,2006,M08,4.7,161993,3462840,3300847
Minnesota,2013,M08,4.6,137459,2965943,2828484
Florida,2007,M04,3.3,301375,9087659,8786284
Montana,2012,M04,6.1,30805,502950,472145
Illinois,2007,M05,4.5,299651,6611229,6311578
North Dakota,2005,M05,3.1,10987,356231,345244
New Hampshire,2008,M05,3.5,26048,738202,712154
Hawaii,2016,M11,2.9,19950,692102,672152
Illinois,2003,M03,6.9,431731,6272602,5840871
Nevada,2002,M07,5.7,64304,1135332,1071028
Hawaii,2006,M10,2.3,14817,636211,621394
Ohio,2006,M05,5.1,299538,5920473,5620935
Alaska,2001,M12,6.8,21720,318934,297214
Mississippi,2009,M07,9.9,127132,1280152,1153020
Vermont,2002,M08,3.8,13066,347639,334573
Nevada,2008,M10,7.6,103867,1368837,1264970
Delaware,2002,M07,4.1,17130,420452,403322
Alabama,2012,M03,7.9,172432,2171589,1999157
Arkansas,2003,M05,5.9,75484,1270611,1195127
Colorado,2001,M04,3.0,70399,2356208,2285809
Wisconsin,2012,M02,8.2,252353,3062856,2810503
Georgia,2010,M03,10.4,485492,4660915,4175423
Massachusetts,2012,M01,7.4,256351,3444591,3188240
Wisconsin,2009,M03,9.3,287291,3100095,2812804
South Carolina,2010,M11,10.9,233542,2147250,1913708
Ohio,2003,M02,6.9,401197,5844217,5443020
New Hampshire,2003,M08,4.2,30534,720374,689840
Illinois,2012,M11,8.4,548819,6568174,6019355
Montana,2009,M07,6.2,31842,510490,478648
Massachusetts,2010,M02,9.2,319371,3457572,3138201
North Carolina,2016,M05,4.7,227259,4872058,4644799
Utah,2000,M11,3.2,36816,1155062,1118246
Alaska,2005,M04,7.0,23866,338593,314727
California,2010,M09,11.9,2197318,18393961,16196643
Maryland,2001,M01,3.9,110664,2813287,2702623
Maine,2006,M04,4.6,31945,692074,660129
Idaho,2003,M03,6.6,45261,687335,642074
Kansas,2016,M11,3.8,56378,1482627,1426249
Alabama,2006,M09,3.9,84484,2166333,2081849
Georgia,2001,M03,3.7,158630,4281650,4123020
Wyoming,2014,M02,4.9,14739,303633,288894
Montana,2014,M04,4.7,24017,510929,486912
Wisconsin,2000,M03,4.2,124524,2956061,2831537
Wyoming,2000,M10,3.4,9144,268163,259019
Mississippi,2012,M12,8.9,115837,1299942,1184105
South Carolina,2006,M11,6.2,131898,2118967,1987069
Colorado,2007,M05,3.3,87361,2634206,2546845
Missouri,2015,M07,5.3,166679,3124881,2958202
Nebraska,2001,M08,3.0,28470,953494,925024
New Jersey,2014,M01,7.5,334738,4450507,4115769
Alaska,2002,M03,8.0,25713,321859,296146
South Dakota,2012,M03,4.9,21601,439263,417662
Idaho,2004,M10,4.1,29264,710712,681448
Massachusetts,2002,M05,5.0,169851,3410923,3241072
Maine,2014,M09,4.8,32974,692686,659712
Maine,2005,M07,4.7,33566,717213,683647
California,2006,M02,5.3,936533,17552946,16616413
Louisiana,2008,M09,5.7,119344,2099603,1980259
Texas,2006,M05,4.9,551935,11277803,10725868
Montana,2013,M02,6.4,32649,506392,473743
Utah,2004,M08,5.1,62889,1242526,1179637
Puerto Rico,2005,M11,12.6,175785,1396829,1221044
West Virginia,2014,M05,6.4,51173,794704,743531
Oklahoma,2008,M05,3.5,61531,1738596,1677065
Connecticut,2011,M09,8.4,161089,1907821,1746732
Texas,2012,M04,6.4,805537,12591727,11786190
Michigan,2015,M11,4.3,204635,4760108,4555473
West Virginia,2015,M09,5.9,45997,782634,736637
Oklahoma,2009,M09,6.8,119691,1765307,1645616
Indiana,2015,M08,4.5,146848,3271323,3124475
Alaska,2004,M07,6.5,22634,347031,324397
Kentucky,2004,M09,4.6,90781,1956435,1865654
Virginia,2007,M07,3.1,126825,4091115,3964290
Puerto Rico,2000,M05,10.0,133038,1330820,1197782
Illinois,2015,M01,6.9,442150,6444670,6002520
West Virginia,2010,M03,9.3,74828,804107,729279
Florida,2016,M09,5.1,508834,9946538,9437704
Texas,2001,M12,5.6,596798,10632619,10035821
Oklahoma,2012,M03,5.1,90598,1790012,1699414
Vermont,2009,M11,6.0,21513,357589,336076
Utah,2015,M07,3.9,57075,1477500,1420425
New Jersey,2005,M11,4.7,207693,4423592,4215899
Hawaii,2008,M07,4.4,28813,647977,619164
Rhode Island,2004,M06,5.0,28179,561797,533618
Oregon,2011,M09,8.8,176682,1998566,1821884
New Jersey,2010,M05,9.2,421839,4560800,4138961
North Carolina,2015,M10,5.4,259883,4791386,4531503
Texas,2003,M07,7.1,782978,10957366,10174388
Nebraska,2000,M09,2.6,24036,936622,912586
California,2006,M04,4.9,851019,17537188,16686169
Mississippi,2008,M10,6.8,88697,1298943,1210246
Ohio,2011,M10,8.2,471951,5781246,5309295
New Jersey,2006,M03,5.1,224716,4424336,4199620
North Carolina,2005,M05,5.2,225868,4317974,4092106
Pennsylvania,2000,M10,3.8,230644,6095824,5865180
South Carolina,2010,M03,11.5,246337,2138970,1892633
South Carolina,2010,M02,12.1,258345,2131896,1873551
Maine,2004,M04,4.8,32205,675541,643336
Delaware,2010,M04,8.5,36614,432055,395441
South Dakota,2011,M05,4.6,20444,441219,420775
Nevada,2009,M03,10.5,141383,1351591,1210208
Illinois,2008,M07,6.6,446487,6752703,6306216
Puerto Rico,2002,M11,11.0,145044,1322475,1177431
Iowa,2011,M09,5.2,85465,1651868,1566403
Massachusetts,2009,M11,8.3,287078,3469707,3182629
New Jersey,2014,M12,6.1,273954,4526110,4252156
New York,2006,M06,4.5,428459,9590323,9161864
Rhode Island,2013,M08,9.4,52657,563057,510400
Arizona,2000,M01,4.2,105985,2497563,2391578
Illinois,2011,M05,9.3,612156,6562644,5950488
West Virginia,2005,M03,5.9,45697,778113,732416
Oklahoma,2003,M03,5.4,90508,1677357,1586849
Massachusetts,2005,M11,4.7,157812,3392283,3234471
Arkansas,2006,M07,5.7,78201,1382210,1304009
New Mexico,2011,M08,7.8,72609,931780,859171
Nevada,2015,M07,7.0,99706,1421677,1321971
Mississippi,2011,M04,9.3,124968,1336910,1211942
Hawaii,2016,M03,3.0,20494,681602,661108
Wyoming,2008,M05,2.7,7985,290627,282642
Hawaii,2016,M02,3.0,20426,679931,659505
South Dakota,2015,M12,2.9,13007,448769,435762
South Dakota,2006,M08,3.0,13454,442415,428961
New Hampshire,2003,M09,4.1,28933,706502,677569
West Virginia,2002,M01,6.4,50919,795089,744170
Oklahoma,2004,M01,5.7,94847,1673278,1578431
Maine,2011,M06,7.7,54185,708045,653860
Massachusetts,2002,M10,5.0,172448,3437024,3264576
Montana,2012,M03,7.0,35043,500855,465812
District of Columbia,2009,M03,8.5,28061,330812,302751
North Dakota,2006,M12,3.1,11311,360678,349367
Arizona,2012,M12,7.7,231963,3024926,2792963
Colorado,2012,M08,7.7,213516,2766894,2553378
Tennessee,2009,M02,10.5,319282,3053694,2734412
Montana,2015,M08,3.7,19365,527419,508054
Missouri,2010,M11,9.3,284527,3050476,2765949
Wyoming,2003,M01,5.4,14428,269245,254817
Puerto Rico,2006,M04,9.8,141999,1442682,1300683
New York,2001,M11,5.7,521046,9159284,8638238
Connecticut,2008,M11,6.1,115891,1890389,1774498
California,2001,M04,4.9,843091,17058851,16215760
Hawaii,2007,M12,2.9,18492,637563,619071
Louisiana,2000,M12,5.2,105293,2032831,1927538
Michigan,2001,M02,5.1,261040,5150376,4889336
Alaska,2009,M05,7.7,27814,360406,332592
Indiana,2000,M06,3.3,105613,3167629,3062016
Montana,2002,M10,3.8,17754,466281,448527
Rhode Island,2003,M01,6.4,35650,557857,522207
North Dakota,2014,M05,2.4,9784,415964,406180
Oregon,2004,M05,7.0,127949,1828138,1700189
Delaware,2007,M02,3.9,17228,440037,422809
North Dakota,2015,M09,2.2,9130,412803,403673
Georgia,2007,M07,5.0,240181,4846658,4606477
South Carolina,2000,M04,3.2,63244,1993355,1930111
Massachusetts,2012,M12,6.6,228992,3493490,3264498
Kansas,2008,M08,5.0,74539,1499447,1424908
Indiana,2007,M12,4.7,149241,3202776,3053535
Iowa,2005,M11,3.8,62886,1641762,1578876
Idaho,2011,M05,7.9,60007,762490,702483
New Jersey,2005,M07,4.7,208811,4469383,4260572
Utah,2012,M03,6.0,81556,1358633,1277077
New Hampshire,2013,M03,5.7,42418,741136,698718
Montana,2007,M06,3.6,18416,509927,491511
New Mexico,2000,M01,5.4,45220,833508,788288
Florida,2010,M10,10.9,1012849,9267201,8254352
Washington,2000,M09,4.7,141916,3030356,2888440
Kansas,2000,M05,3.4,47866,1405662,1357796
Iowa,2000,M10,2.3,37099,1595986,1558887
Washington,2003,M08,7.3,227825,3135249,2907424
Colorado,2016,M11,2.7,78408,2899265,2820857
West Virginia,2008,M02,5.4,43631,808741,765110
Oklahoma,2014,M02,5.2,93345,1778986,1685641
Ohio,2006,M01,5.9,345368,5824414,5479046
New Jersey,2013,M06,8.6,397352,4603525,4206173
Utah,2016,M05,3.4,50903,1504567,1453664
New York,2016,M06,4.7,455409,9644655,9189246
Louisiana,2005,M05,5.6,115392,2068953,1953561
Minnesota,2005,M05,3.7,106870,2877931,2771061
Kansas,2016,M12,3.8,56522,1474815,1418293
Virginia,2008,M03,3.6,148300,4103993,3955693
Nevada,2002,M05,5.4,60875,1126821,1065946
Delaware,2013,M09,6.3,27701,438847,411146
Texas,2008,M10,5.1,600302,11789071,11188769
Michigan,2010,M08,12.3,591624,4822030,4230406
Wyoming,2012,M04,5.5,16686,305671,288985
New York,2005,M09,5.0,478594,9477879,8999285
West Virginia,2002,M05,6.0,48211,804906,756695
Connecticut,2006,M05,4.2,76384,1823180,1746796
Oklahoma,2004,M05,4.9,81787,1683631,1601844
Nebraska,2013,M10,3.3,33756,1015367,981611
Missouri,2013,M09,6.2,187936,3016349,2828413
Michigan,2003,M12,6.4,320292,5019350,4699058
Idaho,2003,M02,6.6,45297,685228,639931
Oregon,2006,M10,4.6,88484,1907371,1818887
Alabama,2010,M04,10.4,229680,2206232,1976552
Maryland,2000,M09,3.5,98891,2808360,2709469
Wisconsin,2007,M02,6.0,182951,3074766,2891815
Arkansas,2001,M01,5.3,65133,1230108,1164975
Nebraska,2000,M08,2.7,25724,947819,922095
Ohio,2012,M02,8.4,474445,5676420,5201975
New Jersey,2002,M11,5.7,246454,4333129,4086675
Puerto Rico,2009,M07,16.8,219351,1302684,1083333
Vermont,2008,M02,4.9,17358,351468,334110
Rhode Island,2007,M09,5.0,28460,572201,543741
District of Columbia,2011,M11,10.0,34859,350130,315271
Kansas,2003,M12,5.2,75823,1444708,1368885
Delaware,2001,M10,3.2,13412,420194,406782
District of Columbia,2000,M05,5.0,15193,304966,289773
New Jersey,2014,M06,6.5,297984,4554151,4256167
Hawaii,2010,M06,7.5,48808,652004,603196
Maryland,2015,M12,4.4,138190,3143936,3005746
North Dakota,2001,M01,3.6,12094,337748,325654
New Mexico,2010,M04,7.9,74198,935605,861407
Wyoming,2011,M12,5.7,17602,306890,289288
Maryland,2016,M08,4.4,139987,3191365,3051378
Tennessee,2000,M03,4.0,114501,2849124,2734623
District of Columbia,2013,M07,8.7,33128,379513,346385
Maryland,2003,M08,4.4,126588,2905441,2778853
Ohio,2016,M02,5.5,311702,5688315,5376613
Wisconsin,2016,M11,3.7,113945,3116760,3002815
Puerto Rico,2000,M01,11.7,151512,1298168,1146656
New York,2010,M12,8.2,778927,9476174,8697247
Colorado,2011,M10,7.8,216581,2761311,2544730
Washington,2001,M03,6.4,195905,3054313,2858408
Georgia,2003,M10,4.4,194746,4396545,4201799
Michigan,2001,M10,5.1,259226,5075048,4815822
Mississippi,2000,M02,5.8,76362,1319129,1242767
Wisconsin,2006,M10,3.9,119110,3069422,2950312
Alabama,2009,M04,9.9,214271,2162016,1947745
Massachusetts,2008,M01,5.4,184500,3412797,3228297
Wisconsin,2013,M03,7.6,230966,3058221,2827255
Georgia,2006,M10,4.5,212047,4760086,4548039
North Dakota,2003,M10,2.7,9298,347550,338252
Wisconsin,2016,M09,3.8,117402,3127214,3009812
New Hampshire,2014,M05,4.2,30867,736002,705135
Washington,2015,M01,6.5,228208,3511413,3283205
Indiana,2008,M11,6.8,221204,3231500,3010296
Ohio,2007,M07,5.8,351064,6068927,5717863
Arizona,2007,M12,4.2,128842,3057653,2928811
Vermont,2007,M06,3.9,14117,358446,344329
Texas,2006,M07,5.4,610041,11402334,10792293
Florida,2006,M07,3.6,330808,9082896,8752088
North Dakota,2014,M10,2.0,8322,418451,410129
Alaska,2010,M06,7.8,28830,368539,339709
Wyoming,2007,M12,2.5,7310,287174,279864
Colorado,2006,M05,4.3,110885,2599856,2488971
Tennessee,2014,M02,6.9,208917,3020254,2811337
Puerto Rico,2009,M09,16.8,217214,1294289,1077075
New Hampshire,2013,M11,4.7,34928,740288,705360
Wyoming,2002,M09,3.5,9416,270060,260644
Arkansas,2001,M03,4.9,61319,1250761,1189442
Arkansas,2004,M10,4.9,64190,1309866,1245676
Iowa,2012,M04,4.8,78359,1648454,1570095
North Dakota,2002,M05,3.4,11628,342523,330895
Michigan,2008,M08,8.3,408942,4952091,4543149
Oregon,2000,M05,4.9,88628,1813210,1724582
Arizona,2012,M11,7.6,228714,3025257,2796543
Alaska,2006,M12,6.6,22828,346777,323949
New Mexico,2014,M03,6.8,62458,915765,853307
Minnesota,2014,M03,5.4,158252,2957190,2798938
New Hampshire,2015,M04,3.5,25644,735417,709773
Georgia,2005,M03,5.2,235272,4523946,4288674
South Carolina,2014,M07,7.0,157499,2258761,2101262
New Jersey,2010,M07,9.8,452614,4619484,4166870
South Carolina,2010,M10,10.5,225348,2149509,1924161
Wisconsin,2004,M03,6.3,190218,3032557,2842339
Illinois,2001,M08,5.4,350082,6430897,6080815
California,2014,M01,8.4,1570680,18589729,17019049
Nevada,2005,M04,4.0,48524,1212140,1163616
Kansas,2013,M04,5.1,75032,1480415,1405383
New Mexico,2004,M04,5.3,47779,895097,847318
Washington,2011,M05,9.3,320667,3457433,3136766
Vermont,2000,M06,2.8,9371,335621,326250
North Carolina,2015,M05,6.1,292752,4825674,4532922
Illinois,2004,M06,6.5,415883,6392980,5977097
Nebraska,2001,M04,2.9,27886,950633,922747
Wyoming,2002,M07,3.5,9564,274181,264617
Tennessee,2014,M11,6.0,183753,3048972,2865219
South Carolina,2001,M08,5.8,113325,1958562,1845237
Delaware,2013,M11,5.7,25383,444190,418807
Maryland,2013,M08,6.5,205646,3140954,2935308
Delaware,2014,M11,4.7,21609,458678,437069
New York,2004,M04,5.9,542439,9257768,8715329
Pennsylvania,2006,M02,5.2,320407,6217105,5896698
Illinois,2016,M09,5.6,364791,6517022,6152231
Utah,2009,M12,7.6,102187,1351014,1248827
Ohio,2007,M09,5.4,322311,5995971,5673660
Wisconsin,2010,M12,7.7,236655,3059191,2822536
Utah,2004,M04,5.0,60519,1214521,1154002
Virginia,2000,M05,2.4,85383,3599772,3514389
Wisconsin,2016,M07,4.2,131738,3164480,3032742
New Mexico,2011,M12,7.2,67342,934347,867005
North Dakota,2009,M02,5.1,18503,365874,347371
Minnesota,2007,M03,5.1,146650,2891046,2744396
Maryland,2001,M08,4.2,120536,2848875,2728339
Nebraska,2010,M07,4.7,47686,1009759,962073
Texas,2013,M09,6.1,790406,12930646,12140240
Utah,2012,M01,6.2,84360,1351887,1267527
New York,2002,M08,5.8,539498,9357419,8817921
Georgia,2015,M09,5.7,270850,4770427,4499577
Hawaii,2008,M09,5.1,32203,634247,602044
Illinois,2011,M06,10.2,682725,6670547,5987822
Tennessee,2016,M02,4.6,141482,3089586,2948104
Pennsylvania,2003,M04,5.5,334415,6133194,5798779
South Carolina,2016,M04,4.7,107506,2295233,2187727
Arizona,2001,M02,3.9,99146,2551639,2452493
California,2002,M04,6.6,1136828,17209768,16072940
Maine,2004,M11,4.6,31590,686635,655045
Louisiana,2011,M12,7.0,143146,2054181,1911035
Virginia,2000,M04,2.1,74818,3606350,3531532
New Hampshire,2003,M01,5.0,34836,701152,666316
Ohio,2010,M12,9.2,533897,5776707,5242810
New Jersey,2002,M03,6.1,265316,4347835,4082519
Utah,2003,M08,5.7,69433,1209415,1139982
Alaska,2003,M05,7.7,25715,332140,306425
California,2011,M10,11.3,2092602,18518312,16425710
Kansas,2008,M12,5.0,75963,1508665,1432702
South Dakota,2001,M08,3.0,12660,418862,406202
South Carolina,2003,M09,7.0,139070,2000894,1861824
Wyoming,2003,M03,5.0,13413,270700,257287
North Carolina,2013,M10,7.2,337245,4666020,4328775
Vermont,2002,M02,4.4,14924,339829,324905
Illinois,2002,M01,7.0,446171,6350266,5904095
Tennessee,2014,M10,6.1,184929,3049823,2864894
Michigan,2004,M07,8.0,409868,5136222,4726354
Rhode Island,2009,M01,11.1,62739,567344,504605
Washington,2001,M11,7.0,212388,3033301,2820913
New Jersey,2016,M07,5.5,252733,4591439,4338706
Minnesota,2011,M12,5.7,166614,2932795,2766181
Mississippi,2014,M10,6.9,85741,1248690,1162949
West Virginia,2001,M03,5.7,45937,807451,761514
Oklahoma,2007,M03,4.2,72295,1720791,1648496
Alaska,2013,M01,7.9,28394,360146,331752
Colorado,2015,M08,3.5,100788,2843190,2742402
Idaho,2016,M09,3.4,27770,817802,790032
Virginia,2011,M01,7.1,294293,4160172,3865879
New Hampshire,2016,M05,2.7,20206,743011,722805
Minnesota,2015,M07,3.6,109704,3006275,2896571
Nebraska,2007,M04,2.6,25625,973436,947811
Nevada,2002,M11,5.2,59144,1134735,1075591
Minnesota,2013,M02,5.9,173752,2941702,2767950
Missouri,2008,M02,5.8,174787,2993596,2818809
District of Columbia,2005,M03,7.0,22083,315661,293578
Arizona,2006,M01,4.5,131872,2928442,2796570
Vermont,2003,M04,4.8,16544,341180,324636
Indiana,2010,M01,11.8,371132,3147520,2776388
Illinois,2007,M08,5.1,339242,6694483,6355241
South Carolina,2015,M03,6.0,135347,2248623,2113276
Maine,2013,M08,5.6,40788,724078,683290
Utah,2006,M04,3.0,39007,1299163,1260156
Nevada,2012,M03,11.7,160967,1372530,1211563
Wisconsin,2000,M07,3.7,110299,3011783,2901484
North Dakota,2011,M02,4.3,16233,380062,363829
Wisconsin,2016,M12,3.7,114831,3098335,2983504
Maine,2007,M07,4.5,32085,716325,684240
Massachusetts,2009,M09,8.6,298761,3454883,3156122
Massachusetts,2000,M10,2.1,70030,3318884,3248854
New Hampshire,2010,M05,5.6,41400,735164,693764
Ohio,2002,M07,6.0,353076,5915439,5562363
Nevada,2008,M05,5.8,79214,1363357,1284143
Utah,2009,M05,7.2,97691,1365404,1267713
Texas,2016,M03,4.5,590841,13239718,12648877
Georgia,2015,M08,6.0,286397,4767978,4481581
Louisiana,2011,M04,7.4,152520,2067823,1915303
Georgia,2005,M11,5.2,241667,4648576,4406909
Alaska,2014,M12,6.5,23346,359599,336253
Virginia,2000,M12,1.8,66614,3640425,3573811
New Mexico,2000,M08,4.9,41667,848084,806417
Illinois,2010,M07,10.6,709384,6707711,5998327
Missouri,2016,M10,4.1,126662,3107424,2980762
North Dakota,2001,M06,3.2,11250,352551,341301
Indiana,2008,M06,5.7,185640,3273668,3088028
California,2012,M02,11.3,2079241,18467676,16388435
New Hampshire,2001,M03,3.3,22884,695375,672491
Washington,2014,M07,6.0,211625,3522184,3310559
Montana,2000,M10,4.3,19875,463724,443849
Pennsylvania,2014,M01,6.9,437750,6366949,5929199
Alaska,2006,M09,5.7,20077,350692,330615
District of Columbia,2015,M09,6.8,26201,386122,359921
Colorado,2016,M04,3.5,101832,2871961,2770129
Louisiana,2006,M05,4.3,85631,1978255,1892624
Massachusetts,2007,M04,4.5,151558,3393948,3242390
Utah,2016,M02,4.0,59836,1489692,1429856
New York,2006,M07,4.8,465836,9649341,9183505
South Carolina,2012,M10,8.6,188394,2190133,2001739
Florida,2016,M11,4.8,473563,9927342,9453779
Colorado,2004,M12,5.2,133306,2540909,2407603
Mississippi,2003,M09,5.7,74323,1297214,1222891
South Dakota,2010,M09,4.4,19278,438059,418781
Montana,2015,M06,4.2,21889,526363,504474
Nevada,2004,M04,4.3,50709,1167104,1116395
Wisconsin,2005,M11,4.4,131845,3026938,2895093
North Carolina,2008,M09,5.9,268607,4561535,4292928
Virginia,2012,M03,6.2,263134,4224310,3961176
Virginia,2012,M12,5.6,237710,4208777,3971067
Florida,2008,M10,7.3,673848,9271872,8598024
Idaho,2007,M11,3.0,22813,750804,727991
Connecticut,2008,M02,5.4,100217,1855566,1755349
California,2005,M05,5.0,878044,17461991,16583947
Idaho,2004,M11,4.5,32189,710537,678348
Kansas,2015,M08,4.2,62721,1483407,1420686
Alabama,2002,M08,6.2,129877,2107790,1977913
Wisconsin,2013,M12,6.0,184360,3066070,2881710
West Virginia,2008,M10,3.7,30061,816165,786104
Colorado,2007,M04,3.4,88949,2626835,2537886
Oklahoma,2014,M10,4.1,74678,1812439,1737761
Louisiana,2016,M10,5.9,124482,2118476,1993994
Massachusetts,2016,M04,3.8,136232,3571623,3435391
District of Columbia,2010,M01,10.2,34575,340540,305965
Florida,2010,M02,11.2,1018112,9054241,8036129
South Dakota,2010,M07,4.6,20494,450195,429701
New Jersey,2010,M09,9.2,414609,4523356,4108747
Michigan,2014,M09,6.5,309060,4746251,4437191
Nevada,2013,M09,9.2,126922,1382811,1255889
Montana,2012,M06,6.1,31229,514059,482830
North Dakota,2003,M02,4.7,15845,336772,320927
Maine,2016,M09,3.4,23693,695467,671774
Kentucky,2003,M02,7.0,135454,1940543,1805089
South Carolina,2011,M07,10.8,238045,2205215,1967170
Ohio,2003,M12,5.7,331548,5830636,5499088
Louisiana,2015,M08,6.4,138667,2158654,2019987
Louisiana,2013,M04,6.5,135631,2096666,1961035
Ohio,2014,M04,5.2,295363,5638691,5343328
Wisconsin,2010,M11,7.7,235814,3066617,2830803
Massachusetts,2008,M03,5.0,171813,3413614,3241801
Georgia,2006,M05,4.7,219529,4686325,4466796
Minnesota,2005,M01,5.1,145302,2849574,2704272
Virginia,2005,M03,3.8,145108,3846701,3701593
California,2010,M11,12.3,2268418,18387011,16118593
Colorado,2015,M09,3.2,91016,2835953,2744937
Colorado,2004,M07,5.4,137773,2562431,2424658
Washington,2016,M07,5.4,198745,3675259,3476514
North Dakota,2005,M01,4.3,14940,348566,333626
Florida,2006,M09,3.5,316811,9100602,8783791
Wyoming,2011,M05,5.7,17223,304630,287407
Alaska,2009,M12,8.0,28479,355967,327488
Michigan,2010,M06,12.7,618159,4861005,4242846
Minnesota,2015,M01,4.7,138013,2953727,2815714
New Jersey,2006,M06,4.8,215984,4487171,4271187
Georgia,2001,M01,3.8,162892,4268627,4105735
Hawaii,2002,M06,4.7,28533,605152,576619
Missouri,2007,M03,4.9,149193,3030889,2881696
Massachusetts,2011,M07,7.4,258798,3505759,3246961
Idaho,2005,M08,3.5,26060,740041,713981
Rhode Island,2010,M07,11.4,65730,575319,509589
Alabama,2004,M02,6.1,130294,2120376,1990082
Nebraska,2011,M08,4.3,43352,1007483,964131
Washington,2013,M03,7.4,256960,3453116,3196156
Indiana,2004,M04,5.0,157282,3153275,2995993
West Virginia,2004,M12,4.7,36787,775744,738957
Maryland,2014,M03,6.1,189716,3107304,2917588
Oklahoma,2002,M12,5.0,84538,1681262,1596724
North Dakota,2015,M12,3.0,12068,408369,396301
Nebraska,2015,M07,3.5,35434,1025880,990446
Nevada,2013,M11,8.6,119227,1381208,1261981
Georgia,2000,M01,3.8,157066,4185685,4028619
Delaware,2001,M02,4.4,18355,421004,402649
Virginia,2002,M10,3.8,142037,3739074,3597037
Virginia,2006,M07,3.3,132780,4035519,3902739
Mississippi,2011,M12,9.4,125815,1340027,1214212
Wyoming,2011,M04,6.2,18719,304293,285574
Utah,2002,M08,6.1,73393,1193609,1120216
Maryland,2010,M01,8.1,246187,3024802,2778615
Kansas,2001,M08,4.4,61184,1380724,1319540
Alabama,2011,M05,9.6,211820,2205918,1994098
Nebraska,2012,M05,3.8,38786,1016857,978071
Georgia,2001,M10,4.6,194578,4269222,4074644
Wisconsin,2007,M10,4.1,126900,3083927,2957027
Colorado,2005,M04,5.1,129596,2537711,2408115
Oregon,2007,M05,4.7,89954,1905258,1815304
Alaska,2014,M06,7.0,26240,373662,347422
Mississippi,2011,M05,10.2,137080,1349754,1212674
Vermont,2007,M03,4.6,16227,354453,338226
New Jersey,2014,M08,6.8,307552,4545022,4237470
Michigan,2009,M06,15.3,768639,5034560,4265921
Connecticut,2008,M10,6.0,113488,1892967,1779479
Tennessee,2012,M10,7.4,229972,3114324,2884352
New Mexico,2012,M12,6.8,63206,934536,871330
Georgia,2004,M10,4.9,221330,4480678,4259348
New Hampshire,2007,M08,3.3,24519,747551,723032
North Carolina,2003,M04,6.3,268476,4269601,4001125
West Virginia,2006,M06,5.3,43336,818726,775390
Oklahoma,2000,M06,3.4,57311,1683724,1626413
Tennessee,2010,M09,9.0,279774,3100688,2820914
New Hampshire,2016,M11,2.6,19573,749293,729720
New Hampshire,2015,M10,2.8,20700,740457,719757
Puerto Rico,2005,M02,10.0,133810,1336268,1202458
Vermont,2015,M06,3.7,12942,350735,337793
Maryland,2003,M06,4.9,142452,2918112,2775660
Vermont,2014,M01,4.7,16418,347733,331315
Illinois,2013,M10,8.7,570321,6520728,5950407
Delaware,2008,M03,4.2,18900,446885,427985
Oregon,2010,M07,10.4,207144,1999607,1792463
Illinois,2012,M12,9.1,596384,6581803,5985419
Idaho,2015,M06,4.0,32657,808382,775725
Indiana,2011,M05,8.7,277975,3189810,2911835
South Dakota,2009,M11,4.7,20791,441857,421066
Minnesota,2010,M03,8.6,250510,2929378,2678868
Missouri,2010,M06,9.5,292667,3091450,2798783
Alabama,2014,M07,7.5,163944,2179484,2015540
North Carolina,2015,M02,5.9,279674,4727112,4447438
Indiana,2004,M09,4.8,152616,3150768,2998152
Mississippi,2004,M12,6.7,88125,1324575,1236450
Arizona,2008,M02,4.5,136914,3055475,2918561
South Carolina,2014,M11,6.5,146273,2244273,2098000
Alaska,2009,M04,7.9,28141,355025,326884
Virginia,2001,M05,2.8,103918,3673863,3569945
Washington,2006,M10,4.4,146466,3348480,3202014
Virginia,2004,M09,3.5,130789,3778556,3647767
Iowa,2000,M02,3.2,50582,1587910,1537328
South Dakota,2001,M02,3.3,13220,405223,392003
Kansas,2002,M02,5.2,72641,1398031,1325390
Idaho,2006,M01,5.3,39460,740087,700627
Pennsylvania,2002,M09,5.0,309624,6216036,5906412
Colorado,2015,M12,3.5,98229,2844996,2746767
Utah,2004,M11,4.2,52181,1246434,1194253
Massachusetts,2005,M06,5.0,170182,3425248,3255066
Vermont,2008,M06,4.5,16072,358247,342175
Missouri,2007,M01,5.4,162434,3028939,2866505
West Virginia,2011,M11,7.1,57186,805724,748538
Oklahoma,2013,M11,5.1,92269,1811458,1719189
Oregon,2005,M04,6.5,118694,1837701,1719007
Rhode Island,2011,M12,10.9,61279,559935,498656
District of Columbia,2005,M10,5.7,17909,312925,295016
Wyoming,2009,M08,6.1,18563,302187,283624
Virginia,2003,M10,3.7,137587,3746795,3609208
Indiana,2016,M02,5.1,169356,3310569,3141213
Montana,2004,M09,4.1,19656,481105,461449
Minnesota,2003,M02,5.2,149259,2844204,2694945
Indiana,2016,M03,5.1,170289,3327600,3157311
Minnesota,2003,M03,5.4,153142,2855457,2702315
Kentucky,2016,M10,4.6,91044,1997151,1906107
Florida,2005,M04,3.5,305456,8632558,8327102
Missouri,2006,M01,5.2,155538,2982062,2826524
Rhode Island,2003,M03,5.9,32949,556199,523250
Utah,2008,M02,3.5,47227,1364291,1317064
West Virginia,2007,M07,4.5,37018,821068,784050
New Jersey,2007,M01,4.8,210201,4415473,4205272
Kentucky,2000,M10,3.7,72421,1957304,1884883
Oklahoma,2001,M07,3.6,60518,1689058,1628540
Georgia,2005,M12,4.9,226058,4651563,4425505
Virginia,2000,M11,1.8,65845,3609487,3543642
Wyoming,2005,M08,3.2,8967,280147,271180
Idaho,2012,M06,6.9,53714,778810,725096
Vermont,2015,M01,4.4,15222,345084,329862
Arizona,2000,M05,3.8,94604,2487330,2392726
Missouri,2008,M10,6.3,192878,3042602,2849724
Tennessee,2009,M10,10.2,308524,3030636,2722112
Rhode Island,2007,M05,4.7,26987,569226,542239
Texas,2009,M08,8.4,1009840,12004323,10994483
Vermont,2003,M05,4.0,13745,342227,328482
Vermont,2006,M09,3.5,12522,357016,344494
Maine,2005,M05,4.9,34040,691938,657898
Michigan,2013,M04,8.1,377681,4661899,4284218
New Jersey,2011,M01,10.0,450403,4519207,4068804
Missouri,2005,M08,4.9,146752,3003924,2857172
Pennsylvania,2008,M03,5.1,323040,6372149,6049109
New Hampshire,2000,M12,2.4,16594,691043,674449
Puerto Rico,2010,M11,15.6,198086,1267415,1069329
Kansas,2012,M09,5.2,77664,1480154,1402490
Illinois,2003,M06,7.5,480712,6408967,5928255
South Dakota,2012,M05,4.2,18491,442785,424294
Wyoming,2007,M03,3.2,9050,282920,273870
New York,2016,M03,5.1,488592,9650167,9161575
New Hampshire,2010,M04,5.9,43641,733516,689875
West Virginia,2008,M11,4.0,32420,809560,777140
Georgia,2002,M05,4.8,208014,4314844,4106830
New Jersey,2000,M08,3.8,163227,4305260,4142033
Vermont,2011,M01,6.6,23611,358722,335111
Illinois,2006,M01,5.4,341667,6378222,6036555
Hawaii,2000,M12,3.6,22016,607820,585804
Oklahoma,2014,M11,4.0,73644,1820497,1746853
Illinois,2016,M04,5.8,380480,6537340,6156860
Rhode Island,2005,M08,5.2,29589,574291,544702
Utah,2004,M09,4.5,56053,1237164,1181111
Pennsylvania,2002,M11,5.5,340833,6190012,5849179
Washington,2003,M10,6.6,208420,3150785,2942365
Rhode Island,2010,M01,12.1,68157,564462,496305
Maine,2014,M08,4.7,33431,710454,677023
Wisconsin,2009,M10,8.2,251458,3074584,2823126
Maine,2009,M11,7.9,54451,690883,636432
California,2009,M10,11.6,2114293,18163796,16049503
Indiana,2005,M03,6.0,189316,3165646,2976330
Iowa,2002,M02,4.6,75083,1632746,1557663
South Dakota,2013,M07,3.4,15465,452704,437239
Georgia,2010,M10,10.5,490549,4690908,4200359
New Hampshire,2011,M07,5.3,39971,748352,708381
Tennessee,2016,M10,5.0,157787,3162841,3005054
Alabama,2008,M12,7.6,164258,2173131,2008873
Kentucky,2012,M06,8.4,176643,2090684,1914041
New York,2013,M05,7.5,720290,9638125,8917835
Mississippi,2015,M04,5.7,71326,1253602,1182276
North Dakota,2010,M10,2.8,10723,380310,369587
Nevada,2008,M02,5.6,75510,1355187,1279677
Connecticut,2016,M11,3.9,73411,1882158,1808747
Virginia,2008,M01,3.7,151395,4071690,3920295
Wyoming,2014,M03,4.7,14188,304626,290438
Alaska,2013,M06,7.0,26143,372251,346108
Virginia,2007,M12,3.3,132786,4056745,3923959
California,2004,M04,6.3,1082702,17279763,16197061
Alabama,2015,M05,6.1,132798,2162423,2029625
Arkansas,2013,M09,7.0,91419,1306400,1214981
Arkansas,2003,M10,5.4,68498,1276627,1208129
Texas,2002,M02,6.1,653584,10660537,10006953
Ohio,2007,M11,5.1,308574,6006795,5698221
Colorado,2008,M08,4.9,133939,2734535,2600596
Virginia,2009,M01,6.1,248775,4110436,3861661
South Dakota,2009,M01,5.0,22029,441244,419215
Washington,2005,M04,5.5,177507,3235013,3057506
New York,2001,M12,5.9,543430,9188005,8644575
Mississippi,2000,M08,5.3,69410,1312692,1243282
North Dakota,2005,M06,3.8,13728,364119,350391
Arkansas,2009,M11,7.6,101897,1346098,1244201
North Carolina,2011,M07,10.7,497971,4657847,4159876
Connecticut,2011,M08,8.9,171750,1930253,1758503
North Dakota,2007,M07,2.9,10897,375213,364316
California,2004,M05,5.9,1022495,17269858,16247363
South Carolina,2007,M06,5.9,126476,2159655,2033179
Wisconsin,2002,M09,4.5,135751,3027054,2891303
North Carolina,2012,M05,9.2,431458,4699774,4268316
District of Columbia,2015,M07,7.0,27685,393728,366043
Alabama,2001,M09,5.3,110866,2109068,1998202
New Hampshire,2012,M04,5.3,38936,732286,693350
Indiana,2015,M05,4.9,159744,3292778,3133034
Rhode Island,2016,M08,5.5,30925,558556,527631
Connecticut,2007,M12,4.4,81831,1860693,1778862
Michigan,2002,M11,5.7,282803,4982533,4699730
North Dakota,2009,M06,4.5,16809,377391,360582
Wisconsin,2016,M06,4.5,141330,3164710,3023380
Nevada,2000,M04,3.9,41247,1052452,1011205
Kansas,2014,M04,4.2,62899,1488142,1425243
Colorado,2004,M05,5.3,132112,2509084,2376972
Alabama,2016,M02,6.3,135407,2152446,2017039
Pennsylvania,2012,M01,8.3,531932,6383908,5851976
Illinois,2007,M09,4.9,325608,6694919,6369311
Kansas,2003,M10,5.4,78043,1442940,1364897
Minnesota,2006,M11,3.7,108382,2896293,2787911
Nebraska,2013,M11,3.1,31254,1013625,982371
Maine,2013,M09,5.7,40132,708887,668755
Wisconsin,2014,M01,6.4,196209,3048638,2852429
Montana,2011,M04,7.2,35882,498932,463050
Oregon,2004,M02,8.5,155092,1829015,1673923
Louisiana,2011,M09,7.7,160580,2076857,1916277
Arizona,2011,M10,9.2,281277,3042904,2761627
Tennessee,2002,M07,5.1,148377,2932269,2783892
Connecticut,2012,M09,8.2,154446,1873822,1719376
Maryland,2004,M12,4.0,116414,2892183,2775769
North Carolina,2016,M12,4.9,238340,4888173,4649833
West Virginia,2012,M09,7.0,56876,812127,755251
Alabama,2013,M03,7.1,154578,2164327,2009749
South Carolina,2004,M06,7.3,151443,2067640,1916197
Oklahoma,2010,M09,6.5,114952,1767861,1652909
Kentucky,2007,M09,5.0,101857,2024969,1923112
Delaware,2012,M04,7.1,31498,445988,414490
Tennessee,2006,M12,4.4,134989,3090725,2955736
Oregon,2008,M09,6.4,125730,1966190,1840460
Alabama,2011,M07,10.4,229090,2213352,1984262
New Mexico,2003,M01,6.0,53029,878165,825136
Texas,2013,M04,6.0,766256,12840105,12073849
Nevada,2012,M01,12.3,168172,1367339,1199167
Massachusetts,2012,M03,6.8,234841,3456346,3221505
Oregon,2007,M11,4.9,96128,1942560,1846432
Washington,2007,M04,4.5,149764,3364694,3214930
Nebraska,2007,M09,2.8,27732,974956,947224
Mississippi,2009,M04,8.5,108045,1271353,1163308
Arizona,2015,M09,6.1,192588,3176393,2983805
Georgia,2012,M02,9.7,464606,4774238,4309632
Nebraska,2004,M08,3.7,35700,973656,937956
Connecticut,2016,M03,5.9,110688,1890541,1779853
New York,2000,M07,4.6,420770,9225166,8804396
Arkansas,2014,M08,5.9,76895,1306259,1229364
New York,2012,M10,8.0,775887,9676954,8901067
Indiana,2008,M02,5.3,170221,3189092,3018871
New Hampshire,2007,M12,3.2,23553,736509,712956
Louisiana,2005,M03,5.4,109878,2035274,1925396
Idaho,2007,M09,2.4,17998,754696,736698
South Dakota,2008,M05,2.7,12185,446653,434468
Connecticut,2006,M03,4.5,81371,1806821,1725450
Indiana,2015,M10,4.3,140534,3288886,3148352
Utah,2016,M06,3.8,57738,1519515,1461777
Indiana,2011,M07,9.4,303283,3211449,2908166
Hawaii,2006,M06,3.4,21928,642705,620777
Alabama,2000,M03,4.5,95449,2134103,2038654
Texas,2015,M06,4.7,619670,13086013,12466343
Wyoming,2011,M11,5.6,17208,308172,290964
Hawaii,2011,M08,6.9,45324,660342,615018
New Hampshire,2004,M09,3.3,23870,714842,690972
Arkansas,2010,M02,9.0,119464,1333015,1213551
Minnesota,2002,M05,4.1,115511,2851293,2735782
South Dakota,2015,M10,2.4,10839,451270,440431
Hawaii,2013,M07,4.8,31428,653626,622198
California,2013,M08,8.9,1668158,18689712,17021554
Massachusetts,2006,M09,4.9,166663,3405809,3239146
Maine,2006,M07,4.5,31954,718051,686097
Nebraska,2013,M02,4.3,43694,1013830,970136
California,2005,M03,5.9,1022813,17427663,16404850
North Dakota,2008,M01,3.8,13698,364030,350332
Nevada,2011,M05,12.9,177229,1371783,1194554
West Virginia,2001,M05,4.8,39048,811871,772823
Texas,2008,M02,4.3,493903,11486602,10992699
Maine,2016,M08,3.3,23400,710951,687551
Florida,2004,M07,5.0,425351,8529973,8104622
Kentucky,2016,M03,5.5,108376,1983653,1875277
Oklahoma,2007,M05,4.3,73818,1722245,1648427
New Hampshire,2016,M04,2.8,20652,741348,720696
Arizona,2012,M10,8.0,242487,3044780,2802293
Wisconsin,2015,M01,5.4,165814,3068152,2902338
Vermont,2011,M06,5.3,19108,361641,342533
Ohio,2000,M11,3.4,199389,5790298,5590909
Utah,2012,M07,5.5,75884,1381453,1305569
Alabama,2009,M03,10.4,225045,2166423,1941378
Wisconsin,2013,M07,6.7,210577,3130827,2920250
North Dakota,2012,M09,2.5,9919,400205,390286
Texas,2015,M04,4.0,526184,13018782,12492598
Maine,2007,M04,4.9,33902,692659,658757
Puerto Rico,2013,M04,13.0,149646,1148390,998744
Missouri,2014,M06,6.3,195199,3090971,2895772
Georgia,2008,M07,6.5,322338,4986620,4664282
Alabama,2016,M12,5.9,129295,2180260,2050965
Illinois,2009,M08,10.6,705791,6655174,5949383
Kentucky,2002,M04,5.4,104429,1937167,1832738
Louisiana,2004,M02,5.6,111051,1997446,1886395
New Jersey,2000,M01,4.2,179743,4267864,4088121
South Dakota,2005,M09,3.3,14333,429003,414670
New Hampshire,2010,M10,5.2,37832,733711,695879
New Hampshire,2014,M07,4.1,31245,754161,722916
Rhode Island,2012,M07,10.5,59122,564417,505295
Vermont,2012,M01,5.8,20513,354497,333984
California,2015,M09,5.6,1045795,18830144,17784349
Minnesota,2012,M08,5.5,162939,2961767,2798828
Iowa,2003,M07,4.4,70491,1619370,1548879
Delaware,2005,M11,3.8,16702,440140,423438
Kansas,2003,M05,5.2,73547,1425451,1351904
New York,2006,M11,4.1,389205,9506104,9116899
Florida,2008,M01,5.0,452879,9147940,8695061
Alabama,2003,M01,6.2,129966,2104340,1974374
Colorado,2006,M07,4.4,117878,2650271,2532393
Colorado,2009,M08,7.4,202846,2740835,2537989
South Dakota,2004,M11,3.6,15458,428249,412791
New Mexico,2008,M04,3.7,34759,937141,902382
Alaska,2014,M08,6.0,22404,371586,349182
Vermont,2004,M06,3.6,12594,351945,339351
Washington,2011,M12,8.8,304655,3452679,3148024
Virginia,2016,M01,4.2,175530,4179096,4003566
Colorado,2010,M03,9.1,247339,2711033,2463694
Kansas,2004,M07,5.7,85239,1490179,1404940
Wisconsin,2002,M12,5.1,154578,3029303,2874725
Delaware,2015,M03,5.0,23329,462293,438964
Iowa,2016,M07,3.7,63255,1723032,1659777
Delaware,2010,M09,8.1,35218,432689,397471
Ohio,2001,M05,3.5,203993,5789386,5585393
New York,2006,M09,4.2,396191,9447560,9051369
Missouri,2010,M09,9.2,282631,3058839,2776208
Utah,2009,M11,7.2,98200,1356935,1258735
Maryland,2003,M09,4.2,120656,2876224,2755568
District of Columbia,2011,M10,10.1,35453,349762,314309
Arizona,2006,M12,3.6,110093,3042227,2932134
South Dakota,2003,M03,4.0,16751,418405,401654
Georgia,2005,M05,5.3,240477,4572899,4332422
Delaware,2002,M11,3.4,14255,413350,399095
New York,2014,M08,6.2,592694,9597297,9004603
Washington,2015,M07,5.5,197936,3568691,3370755
Alabama,2002,M02,6.3,132979,2099541,1966562
Idaho,2015,M07,4.0,32595,810715,778120
Alabama,2015,M04,5.5,118352,2144272,2025920
Kentucky,2009,M07,10.8,225482,2086399,1860917
Pennsylvania,2010,M07,8.7,563537,6479941,5916404
Virginia,2014,M11,4.7,199640,4216852,4017212
Texas,2012,M10,6.2,797319,12769132,11971813
New Jersey,2009,M06,9.3,427294,4615728,4188434
Connecticut,2004,M07,5.2,94607,1807873,1713266
Hawaii,2009,M06,7.9,49992,636751,586759
Puerto Rico,2000,M03,10.4,136164,1314761,1178597
Indiana,2014,M11,5.7,184641,3254852,3070211
Maryland,2015,M02,5.6,175306,3115309,2940003
New York,2011,M02,8.8,834190,9482067,8647877
Louisiana,2003,M07,7.2,147269,2050313,1903044
Puerto Rico,2011,M04,16.5,201961,1221071,1019110
Connecticut,2000,M12,1.8,32014,1753316,1721302
Mississippi,2016,M09,5.7,72753,1282108,1209355
New Hampshire,2011,M11,5.2,38440,735837,697397
Pennsylvania,2016,M08,5.9,381313,6509403,6128090
Arizona,2004,M06,5.4,152130,2800591,2648461
Iowa,2015,M10,3.3,56686,1703231,1646545
Alabama,2008,M05,4.9,106293,2174485,2068192
Illinois,2012,M05,8.6,566487,6566671,6000184
New Mexico,2013,M04,6.4,58703,920759,862056
Iowa,2014,M09,3.9,66224,1705044,1638820
Utah,2007,M10,2.5,34291,1371705,1337414
Wisconsin,2011,M10,6.7,206764,3078481,2871717
North Carolina,2016,M11,4.9,241445,4921006,4679561
Connecticut,2015,M06,5.7,107994,1907723,1799729
Mississippi,2007,M08,5.6,72619,1293453,1220834
Illinois,2003,M12,6.2,387566,6289368,5901802
Delaware,2005,M07,4.3,19066,439160,420094
Minnesota,2006,M05,3.3,95752,2871913,2776161
Wisconsin,2002,M07,5.3,161206,3057405,2896199
Nevada,2004,M10,3.8,45815,1190122,1144307
Wisconsin,2008,M12,6.0,186183,3090917,2904734
Louisiana,2012,M06,8.2,174431,2122484,1948053
Kansas,2010,M03,7.5,111681,1495373,1383692
North Carolina,2013,M01,9.7,451631,4676024,4224393
Arizona,2002,M02,5.7,152336,2649962,2497626
Louisiana,2006,M01,6.1,118541,1957108,1838567
Alaska,2000,M08,5.2,17017,325040,308023
Massachusetts,2007,M10,4.0,135343,3417737,3282394
Oregon,2013,M10,7.2,136732,1910367,1773635
Maine,2009,M08,7.3,51542,710836,659294
New Mexico,2008,M08,4.7,44296,947472,903176
Indiana,2013,M01,9.6,302796,3170466,2867670
Alabama,2008,M04,4.0,86201,2162674,2076473
Puerto Rico,2006,M09,11.0,156174,1419640,1263466
New Mexico,2014,M07,7.4,68710,927637,858927
Minnesota,2014,M10,3.1,92403,2961263,2868860
Indiana,2011,M09,9.0,288198,3201358,2913160
Colorado,2005,M07,5.0,129311,2588564,2459253
Montana,2006,M07,3.1,15950,508402,492452
New Mexico,2012,M09,6.8,63150,924087,860937
Washington,2009,M02,8.5,298821,3516914,3218093
New Mexico,2009,M05,7.6,71167,938751,867584
California,2014,M12,6.6,1246940,18768292,17521352
Illinois,2003,M02,7.1,448631,6274697,5826066
North Dakota,2013,M06,3.1,12949,416459,403510
Iowa,2011,M12,5.5,90049,1649739,1559690
South Dakota,2007,M08,2.6,11729,449146,437417
Nevada,2011,M01,13.9,190211,1365532,1175321
Indiana,2007,M02,5.3,169778,3198012,3028234
Massachusetts,2003,M04,5.5,188747,3405946,3217199
Virginia,2004,M12,3.5,133600,3807804,3674204
Iowa,2014,M07,4.2,72789,1725192,1652403
Connecticut,2005,M01,5.4,94626,1765053,1670427
New York,2013,M11,7.0,674232,9570660,8896428
Washington,2005,M09,5.2,168854,3275011,3106157
West Virginia,2000,M01,6.5,51838,799044,747206
Oklahoma,2006,M01,4.3,72352,1692767,1620415
Alaska,2012,M04,7.5,26992,360842,333850
Utah,2009,M03,7.3,100202,1368854,1268652
Utah,2002,M10,5.6,66575,1193658,1127083
Wisconsin,2005,M12,4.5,135711,3028064,2892353
New Jersey,2003,M11,5.2,226264,4345993,4119729
West Virginia,2012,M07,7.6,61675,816043,754368
Oklahoma,2010,M07,6.7,118609,1780434,1661825
Nevada,2001,M10,5.9,65884,1121482,1055598
Mississippi,2004,M05,5.9,77966,1312623,1234657
Texas,2014,M09,4.9,639045,13010419,12371374
Wisconsin,2012,M10,6.0,183686,3076594,2892908
New Jersey,2014,M10,6.3,284236,4533771,4249535
Washington,2007,M11,4.6,158285,3443663,3285378
New Hampshire,2013,M05,4.9,36112,738045,701933
Hawaii,2007,M09,3.1,19648,631853,612205
Maine,2006,M05,4.5,31084,695110,664026
North Dakota,2009,M08,3.8,14239,373855,359616
Hawaii,2006,M05,2.7,17391,636212,618821
Indiana,2008,M05,5.2,168854,3239880,3071026
Kentucky,2015,M08,4.9,95406,1949983,1854577
Maine,2016,M12,3.5,24167,688709,664542
Washington,2010,M02,11.2,395374,3522418,3127044
Rhode Island,2000,M12,3.6,19511,544834,525323
Arkansas,2004,M12,5.4,70702,1312722,1242020
Arkansas,2014,M04,5.7,74260,1292040,1217780
Nebraska,2006,M06,3.3,32379,982096,949717
New Hampshire,2013,M04,5.1,37879,735614,697735
Connecticut,2010,M01,9.5,179315,1880550,1701235
Rhode Island,2002,M09,4.6,25397,552507,527110
Kansas,2009,M07,7.9,122127,1551042,1428915
Michigan,2007,M02,7.2,359864,5005248,4645384
Pennsylvania,2012,M10,7.5,485077,6488442,6003365
Kansas,2003,M01,5.7,80350,1421836,1341486
Pennsylvania,2007,M02,4.8,300798,6261256,5960458
Utah,2005,M11,3.4,44501,1292597,1248096
New Hampshire,2005,M02,4.2,30217,717923,687706
Iowa,2009,M04,6.3,106655,1691482,1584827
Kentucky,2007,M06,5.4,112353,2063945,1951592
Illinois,2011,M12,9.2,601947,6576441,5974494
Vermont,2016,M09,3.2,11186,344666,333480
Hawaii,2002,M01,5.1,31123,606196,575073
Wyoming,2009,M10,6.3,18947,300205,281258
Arkansas,2005,M07,5.7,77937,1370368,1292431
Indiana,2013,M10,6.9,218768,3192295,2973527
Mississippi,2003,M12,5.6,73578,1316673,1243095
Alaska,2011,M07,6.8,25571,376479,350908
Connecticut,2000,M01,3.3,57825,1754867,1697042
Idaho,2001,M08,4.7,31976,685680,653704
Iowa,2003,M05,4.1,66194,1601205,1535011
Kansas,2013,M11,4.5,67007,1489664,1422657
Alaska,2014,M04,7.1,25835,361485,335650
Texas,2007,M06,4.6,529279,11469997,10940718
North Dakota,2015,M11,2.5,10166,409269,399103
Washington,2012,M12,7.6,260890,3451211,3190321
District of Columbia,2000,M11,5.9,18386,314048,295662
South Dakota,2007,M04,2.9,12641,439552,426911
New Mexico,2015,M11,6.4,59038,928349,869311
Arkansas,2014,M06,6.2,81894,1317421,1235527
Nebraska,2006,M04,3.0,28954,967895,938941
Oklahoma,2016,M08,5.1,92321,1820146,1727825
Wisconsin,2011,M01,8.8,268449,3055772,2787323
West Virginia,2010,M02,10.0,81181,808540,727359
Oklahoma,2012,M02,5.6,100360,1781614,1681254
Alabama,2005,M03,4.6,97042,2125639,2028597
Massachusetts,2011,M05,7.1,243206,3444808,3201602
Wisconsin,2013,M09,5.9,181664,3083361,2901697
North Dakota,2012,M07,2.8,11565,406324,394759
Idaho,2009,M01,8.7,65438,749873,684435
Maryland,2014,M05,5.8,179302,3116793,2937491
Virginia,2014,M05,5.3,226919,4282601,4055682
Kentucky,2006,M04,5.6,113610,2018368,1904758
Texas,2015,M08,4.6,596865,13016925,12420060
Missouri,2007,M05,4.6,137860,3029463,2891603
North Dakota,2014,M06,2.9,12335,425174,412839
California,2010,M08,12.3,2271603,18443593,16171990
Alaska,2001,M09,5.5,17872,322627,304755
New Hampshire,2016,M12,2.5,18907,747463,728556
Arkansas,2002,M10,4.6,59041,1274174,1215133
North Carolina,2006,M10,4.4,198222,4511156,4312934
Wyoming,2015,M09,3.8,11507,304353,292846
Massachusetts,2000,M08,2.5,83174,3355518,3272344
Arkansas,2008,M04,4.7,64137,1372330,1308193
District of Columbia,2012,M08,9.0,33100,367947,334847
Mississippi,2001,M10,6.1,78087,1286210,1208123
Michigan,2000,M02,3.7,189195,5152077,4962882
Arkansas,2013,M06,7.7,102885,1332155,1229270
Hawaii,2013,M01,5.2,33218,643547,610329
Illinois,2004,M02,6.8,424090,6279463,5855373
Nevada,2000,M07,4.1,44318,1073471,1029153
Mississippi,2011,M07,10.6,144142,1357528,1213386
Wisconsin,2001,M02,5.1,151986,3007074,2855088
Mississippi,2012,M09,8.7,114405,1310014,1195609
New Hampshire,2006,M02,3.9,28203,723724,695521
Arizona,2016,M06,5.7,183455,3239204,3055749
Delaware,2000,M07,3.9,16409,419697,403288
Maine,2008,M08,4.8,34490,717538,683048
Kentucky,2003,M03,6.5,127152,1951132,1823980
North Carolina,2011,M09,10.2,473371,4658035,4184664
Florida,2001,M10,5.8,470074,8063401,7593327
New York,2002,M02,6.8,626602,9254554,8627952
Alabama,2011,M06,10.6,235178,2221913,1986735
Pennsylvania,2015,M02,5.7,365727,6377448,6011721
Minnesota,2000,M07,2.9,82561,2840087,2757526
Georgia,2008,M03,5.2,257321,4904122,4646801
Hawaii,2007,M01,2.5,16176,641344,625168
Wisconsin,2011,M03,8.8,269051,3069038,2799987
Montana,2016,M10,3.7,19296,526549,507253
New Mexico,2000,M10,4.6,39084,852869,813785
Tennessee,2011,M08,9.1,283975,3128467,2844492
Vermont,2012,M06,5.1,18457,359972,341515
Oregon,2001,M04,6.0,109474,1815207,1705733
Arkansas,2016,M02,4.6,61266,1337682,1276416
Missouri,2009,M06,9.7,301238,3111186,2809948
New York,2000,M01,5.3,487748,9122641,8634893
Delaware,2011,M04,7.5,33017,442243,409226
South Dakota,2005,M04,3.9,16632,428538,411906
Kansas,2005,M10,4.6,68010,1466578,1398568
New Jersey,2005,M09,4.5,196645,4388551,4191906
Louisiana,2016,M12,5.4,112436,2084212,1971776
Indiana,2004,M08,5.1,163132,3170732,3007600
Delaware,2005,M05,3.7,15981,428581,412600
Ohio,2010,M09,9.5,552527,5828465,5275938
Michigan,2000,M07,4.6,238399,5214467,4976068
Nevada,2010,M09,13.7,186389,1361013,1174624
District of Columbia,2000,M02,5.7,17613,307728,290115
New Jersey,2012,M07,10.0,464248,4652390,4188142
Arizona,2009,M10,11.0,342755,3129972,2787217
Nebraska,2001,M10,3.0,28298,950648,922350
Maine,2012,M03,8.6,59835,694125,634290
Kentucky,2004,M11,4.7,92520,1972092,1879572
Minnesota,2009,M04,7.8,229756,2942440,2712684
Maryland,2007,M01,4.0,119045,2954714,2835669
District of Columbia,2014,M07,8.1,30983,384048,353065
West Virginia,2000,M11,5.0,40515,808628,768113
Oklahoma,2006,M11,3.9,68310,1730937,1662627
Washington,2002,M04,7.6,233779,3063633,2829854
North Carolina,2014,M01,6.9,320157,4628072,4307915
Alabama,2008,M06,5.9,128630,2195259,2066629
Tennessee,2003,M01,5.8,169266,2902140,2732874
Colorado,2012,M09,7.2,200813,2771479,2570666
Vermont,2004,M08,3.2,11352,351775,340423
Texas,2013,M12,5.4,694318,12895878,12201560
Pennsylvania,2010,M11,7.9,500299,6369703,5869404
Alabama,2002,M10,5.6,118872,2124974,2006102
Hawaii,2013,M06,5.4,34892,651294,616402
Arkansas,2003,M12,5.6,71892,1272841,1200949
Kansas,2001,M02,4.2,58974,1389215,1330241
Rhode Island,2012,M06,10.1,56621,560571,503950
Texas,2008,M06,5.0,587493,11711714,11124221
Louisiana,2012,M04,6.6,137354,2067630,1930276
Vermont,2016,M10,2.5,8720,344510,335790
Puerto Rico,2011,M08,16.4,196707,1196031,999324
Illinois,2010,M02,11.9,787205,6609714,5822509
South Carolina,2006,M09,6.5,136708,2112539,1975831
Oregon,2009,M03,12.6,250173,1984811,1734638
Idaho,2004,M05,4.4,30501,698544,668043
New Jersey,2001,M06,4.1,177523,4316958,4139435
West Virginia,2007,M12,4.3,34835,807619,772784
Puerto Rico,2014,M06,12.8,144367,1123772,979405
Oklahoma,2001,M12,4.4,74070,1687187,1613117
California,2008,M08,7.8,1419146,18292518,16873372
South Carolina,2003,M03,6.4,126125,1974630,1848505
Nebraska,2006,M03,3.3,31740,964428,932688
New York,2014,M06,6.2,598356,9633723,9035367
Montana,2012,M05,5.6,28374,506577,478203
Virginia,2015,M07,4.6,194167,4252571,4058404
Texas,2003,M12,5.8,637758,10936781,10299023
Colorado,2009,M01,6.6,179146,2709221,2530075
Utah,2010,M12,7.3,97886,1350062,1252176
Indiana,2001,M08,4.4,136563,3130618,2994055
Connecticut,2007,M06,4.5,83752,1872630,1788878
Hawaii,2000,M07,4.3,26510,610624,584114
Idaho,2009,M07,8.9,68290,770834,702544
Delaware,2004,M10,3.9,16319,420330,404011
Arizona,2007,M05,3.4,101041,3006195,2905154
Texas,2005,M07,5.6,623335,11166775,10543440
District of Columbia,2006,M03,5.7,17941,312694,294753
Florida,2004,M04,4.3,360743,8338900,7978157
Mississippi,2004,M07,6.7,88820,1328716,1239896
Nebraska,2004,M10,3.5,34425,971449,937024
Louisiana,2004,M10,5.6,115020,2055171,1940151
Tennessee,2013,M08,7.9,241592,3063918,2822326
Massachusetts,2005,M10,4.4,148349,3387839,3239490
South Carolina,2008,M03,5.4,114751,2116630,2001879
Oregon,2015,M10,5.1,102488,2010744,1908256
Nevada,2011,M03,13.4,183466,1369980,1186514
Mississippi,2012,M01,10.0,131791,1323508,1191717
Mississippi,2012,M08,9.0,117335,1307802,1190467
Hawaii,2012,M11,5.3,34218,646179,611961
Tennessee,2001,M12,5.6,163003,2897265,2734262
Idaho,2006,M11,3.0,22753,746539,723786
Louisiana,2012,M12,6.4,132086,2078718,1946632
Tennessee,2006,M01,5.7,166564,2940182,2773618
Arkansas,2004,M08,5.4,71032,1307890,1236858
Virginia,2007,M09,3.0,121759,4042736,3920977
Michigan,2012,M04,8.3,383784,4602170,4218386
District of Columbia,2016,M07,6.3,25186,397407,372221
Arkansas,2000,M07,4.5,57894,1276035,1218141
Montana,2005,M10,3.6,17585,486893,469308
Pennsylvania,2001,M09,4.5,279953,6164238,5884285
Connecticut,2001,M01,3.3,57035,1751209,1694174
Wyoming,2010,M11,6.1,18538,305384,286846
Rhode Island,2007,M08,5.4,31224,578794,547570
Oregon,2014,M11,6.2,121028,1958756,1837728
Arizona,2013,M01,8.2,245892,3016658,2770766
Alaska,2007,M11,6.3,21976,349338,327362
Maryland,2012,M12,6.7,209174,3122592,2913418
District of Columbia,2015,M03,7.1,27023,382877,355854
North Dakota,2013,M03,3.7,14828,401873,387045
Alaska,2008,M04,6.9,24331,350951,326620
Puerto Rico,2004,M12,9.8,133261,1355980,1222719
District of Columbia,2000,M10,5.9,18352,312477,294125
Massachusetts,2016,M03,4.4,157457,3584456,3426999
Wyoming,2000,M01,5.1,13349,261991,248642
Montana,2007,M09,3.3,16809,503431,486622
Colorado,2006,M04,4.4,113139,2593493,2480354
Georgia,2000,M11,3.0,128657,4229446,4100789
Puerto Rico,2013,M08,14.9,174162,1165140,990978
Massachusetts,2003,M12,5.2,177666,3408972,3231306
Arkansas,2005,M05,5.3,70920,1347878,1276958
Missouri,2000,M02,3.9,114229,2937105,2822876
New Mexico,2006,M07,4.8,44513,936473,891960
Oregon,2000,M04,5.0,91551,1814684,1723133
Maryland,2005,M02,4.7,135391,2881458,2746067
Oregon,2015,M11,5.1,102441,2015212,1912771
Massachusetts,2003,M02,6.0,204700,3408454,3203754
Vermont,2000,M10,2.3,7673,333065,325392
Michigan,2013,M07,10.2,489337,4818270,4328933
Vermont,2016,M01,4.0,13564,342359,328795
Vermont,2005,M09,3.2,11286,351884,340598
New Hampshire,2015,M12,2.7,20176,740933,720757
Kansas,2015,M09,3.7,54540,1481212,1426672
Texas,2004,M12,5.5,612261,11053592,10441331
Wisconsin,2006,M05,4.5,137145,3037348,2900203
West Virginia,2005,M02,6.3,48798,778166,729368
Maryland,2000,M12,3.3,92860,2822907,2730047
Oklahoma,2003,M02,5.7,95187,1675031,1579844
Connecticut,2004,M04,4.9,85939,1759123,1673184
Arkansas,2004,M03,6.1,77911,1285341,1207430
Michigan,2003,M09,6.9,345761,5014503,4668742
Nevada,2005,M06,4.3,52914,1225604,1172690
Mississippi,2013,M04,7.9,100356,1268059,1167703
Alabama,2003,M11,6.1,131465,2145995,2014530
Illinois,2016,M07,5.9,386828,6607396,6220568
Utah,2007,M09,2.5,33813,1366778,1332965
Wyoming,2001,M02,4.4,11691,265461,253770
New Mexico,2014,M02,7.1,65132,919805,854673
Virginia,2003,M08,4.1,154806,3753244,3598438
Rhode Island,2011,M02,11.7,65538,558699,493161
Connecticut,2013,M08,8.0,150204,1889006,1738802
Virginia,2016,M03,4.0,170973,4237899,4066926
District of Columbia,2012,M12,8.6,32096,373191,341095
New Hampshire,2008,M11,4.0,29798,740882,711084
Idaho,2013,M10,5.3,40914,775088,734174
South Carolina,2012,M01,10.2,219223,2158506,1939283
Nebraska,2014,M06,3.5,35916,1023660,987744
Virginia,2006,M03,3.2,124824,3946069,3821245
Wyoming,2016,M05,5.7,17102,302387,285285
Minnesota,2007,M02,5.1,146137,2881417,2735280
Idaho,2008,M10,5.4,41161,757322,716161
Arkansas,2015,M11,4.0,53503,1336655,1283152
California,2013,M02,9.7,1802452,18604512,16802060
Alaska,2010,M04,8.3,29494,356659,327165
Rhode Island,2005,M10,4.5,25832,568857,543025
Ohio,2016,M05,4.4,250260,5713907,5463647
Kentucky,2015,M06,5.5,109989,1989682,1879693
Hawaii,2007,M08,2.8,17767,635404,617637
Massachusetts,2012,M05,6.4,220127,3460809,3240682
Hawaii,2005,M05,2.7,16693,623149,606456
Arizona,2008,M07,6.6,206931,3118037,2911106
Kansas,2014,M08,4.7,69285,1488041,1418756
California,2009,M08,11.5,2105749,18254774,16149025
Iowa,2007,M10,3.3,54519,1671159,1616640
Arkansas,2014,M09,5.6,73663,1309106,1235443
California,2002,M05,6.2,1058144,17192070,16133926
Georgia,2014,M11,6.3,300840,4764469,4463629
Tennessee,2004,M12,5.6,160918,2877494,2716576
Alabama,2016,M10,6.2,136336,2193487,2057151
Ohio,2008,M11,6.9,407711,5942191,5534480
New Mexico,2003,M09,5.8,51407,889528,838121
South Carolina,2008,M11,8.0,172247,2140308,1968061
Vermont,2011,M12,4.8,17222,355501,338279
Missouri,2002,M03,6.0,179775,3003873,2824098
Washington,2008,M03,5.2,179880,3455448,3275568
Montana,2006,M01,4.8,23033,483703,460670
Maryland,2016,M11,4.0,126573,3180574,3054001
Maine,2003,M02,5.8,39145,671430,632285
Kansas,2012,M04,5.5,81421,1475416,1393995
Maryland,2011,M03,7.3,223698,3077923,2854225
Idaho,2016,M07,3.6,30081,827800,797719
North Dakota,2006,M05,2.9,10330,361759,351429
Arkansas,2006,M06,5.4,75550,1387703,1312153
Arizona,2003,M05,5.6,153001,2718159,2565158
North Dakota,2002,M06,4.1,14229,350437,336208
New Mexico,2002,M11,5.3,47021,884500,837479
New Hampshire,2005,M10,3.2,23028,725752,702724
Michigan,2000,M05,3.4,173681,5160377,4986696
Ohio,2000,M12,3.4,199023,5794266,5595243
New Jersey,2012,M05,9.3,425279,4586458,4161179
Tennessee,2015,M09,5.3,161544,3061680,2900136
Vermont,2004,M03,4.5,15474,346249,330775
South Dakota,2015,M05,3.1,13983,452657,438674
Illinois,2005,M08,5.4,346463,6435811,6089348
Illinois,2006,M10,3.6,240168,6589427,6349259
New Hampshire,2004,M08,3.5,25758,727421,701663
Mississippi,2014,M11,6.4,80040,1247026,1166986
Washington,2003,M12,7.0,220647,3160057,2939410
Illinois,2000,M09,4.0,254721,6441182,6186461
Arkansas,2003,M02,6.3,79175,1262912,1183737
Maryland,2000,M01,3.7,101037,2763818,2662781
Minnesota,2002,M06,4.7,134596,2884233,2749637
Minnesota,2010,M09,6.9,203430,2941482,2738052
North Carolina,2004,M10,4.9,210154,4258716,4048562
Illinois,2016,M11,5.2,340691,6493487,6152796
Massachusetts,2011,M01,8.5,293670,3453062,3159392
Minnesota,2008,M08,5.4,158404,2950216,2791812
New Mexico,2005,M03,5.5,49629,907776,858147
Washington,2006,M06,5.0,167755,3336242,3168487
Arkansas,2005,M06,5.5,75344,1366893,1291549
Indiana,2004,M03,5.9,186633,3153645,2967012
Oregon,2001,M11,7.4,135513,1832260,1696747
Georgia,2012,M03,9.3,444208,4781305,4337097
Mississippi,2007,M10,5.7,75212,1312175,1236963
Pennsylvania,2002,M04,5.4,334859,6187155,5852296
Wisconsin,2015,M03,5.3,162565,3070504,2907939
Idaho,2006,M12,3.4,25339,747906,722567
Vermont,2015,M10,2.8,9681,343973,334292
Washington,2004,M11,5.8,185875,3218970,3033095
Tennessee,2004,M04,4.7,135139,2855892,2720753
Tennessee,2000,M02,4.2,119757,2849692,2729935
Massachusetts,2007,M08,4.3,147834,3459066,3311232
Arizona,2014,M12,6.1,191549,3130711,2939162
Florida,2000,M07,4.1,326284,7895992,7569708
Maryland,2009,M05,6.9,208524,3028472,2819948
Florida,2003,M05,5.1,418903,8196572,7777669
Texas,2012,M12,6.2,791201,12759851,11968650
Maine,2008,M03,5.7,39362,694006,654644
Utah,2013,M12,3.8,53947,1419007,1365060
Arizona,2012,M09,8.2,249483,3043719,2794236
Alaska,2003,M02,9.0,29410,327946,298536
Tennessee,2006,M06,5.7,176671,3074169,2897498
Washington,2005,M06,5.5,179965,3275804,3095839
Hawaii,2004,M02,3.6,21584,604067,582483
Tennessee,2007,M01,5.1,157088,3055192,2898104
Kentucky,2005,M10,5.4,108758,2005210,1896452
Florida,2011,M01,10.8,992528,9209683,8217155
Michigan,2012,M10,8.5,397268,4695809,4298541
Minnesota,2000,M03,3.8,105252,2789810,2684558
New Mexico,2012,M01,7.7,71312,923081,851769
South Carolina,2008,M07,6.9,149774,2172167,2022393
Connecticut,2010,M10,8.9,171390,1920967,1749577
Idaho,2000,M09,3.9,26103,661244,635141
Missouri,2004,M04,5.4,160874,3006255,2845381
Rhode Island,2001,M10,4.2,23021,543878,520857
North Carolina,2016,M06,5.2,252690,4877332,4624642
Maine,2011,M12,7.6,53142,697152,644010
North Dakota,2016,M08,2.9,12150,424003,411853
Arkansas,2009,M04,7.5,102313,1365144,1262831
Texas,2015,M03,4.3,556687,12984434,12427747
Puerto Rico,2013,M02,13.9,162959,1175386,1012427
Iowa,2016,M01,4.5,76883,1692611,1615728
Tennessee,2001,M01,4.5,128299,2847649,2719350
Michigan,2002,M01,7.2,358158,4999039,4640881
Illinois,2003,M10,6.3,396094,6294687,5898593
Hawaii,2006,M03,2.8,17625,636188,618563
Oregon,2013,M03,8.7,164314,1890343,1726029
Maryland,2008,M07,4.4,135456,3058767,2923311
Hawaii,2005,M06,3.4,21303,629875,608572
Washington,2009,M10,9.7,345138,3549369,3204231
Nebraska,2010,M03,5.2,50966,988787,937821
Nebraska,2010,M12,4.3,42449,991004,948555
Texas,2000,M06,4.7,487765,10419094,9931329
Missouri,2006,M08,5.2,156624,3037502,2880878
Tennessee,2009,M06,11.3,350574,3104308,2753734
Ohio,2015,M04,4.6,263315,5676774,5413459
Pennsylvania,2008,M05,4.9,316582,6438073,6121491
Puerto Rico,2015,M04,12.6,140447,1113507,973060
Minnesota,2015,M12,3.7,110918,2974678,2863760
Massachusetts,2016,M12,2.8,98949,3575041,3476092
Virginia,2009,M11,6.8,278323,4087097,3808774
Puerto Rico,2006,M06,11.5,164550,1430460,1265910
Louisiana,2015,M05,6.4,139660,2176309,2036649
Nebraska,2008,M07,3.5,35230,1005516,970286
Oregon,2009,M07,11.3,225139,1995759,1770620
Massachusetts,2008,M05,5.0,171873,3423145,3251272
Tennessee,2002,M04,5.2,148797,2886916,2738119
Colorado,2016,M03,3.9,111638,2874045,2762407
Delaware,2014,M01,6.6,29250,444110,414860
Ohio,2005,M12,5.4,316296,5887960,5571664
New Hampshire,2010,M06,5.7,42241,744996,702755
Virginia,2002,M08,4.3,161697,3753163,3591466
Alabama,2013,M04,6.3,136117,2158996,2022879
Kentucky,2011,M05,9.4,194586,2062592,1868006
Wyoming,2015,M10,4.0,12303,304311,292008
Massachusetts,2009,M08,8.2,289311,3521346,3232035
California,2006,M05,4.5,798279,17546965,16748686
District of Columbia,2013,M06,8.8,33338,376752,343414
Ohio,2005,M02,7.1,413095,5829916,5416821
Louisiana,2013,M12,5.0,103557,2083223,1979666
District of Columbia,2001,M04,5.4,16421,306652,290231
South Carolina,2004,M03,6.7,135065,2008298,1873233
New Mexico,2006,M05,4.1,37499,922350,884851
Utah,2000,M02,3.5,39328,1124619,1085291
Texas,2009,M02,6.5,764512,11729736,10965224
Maine,2000,M10,2.7,18505,676285,657780
Rhode Island,2007,M01,5.7,32587,572863,540276
New York,2011,M10,8.2,786747,9546828,8760081
Puerto Rico,2009,M06,15.5,200822,1294392,1093570
Hawaii,2012,M02,6.5,42506,649215,606709
Missouri,2002,M04,5.3,157668,3001004,2843336
Illinois,2016,M03,6.4,419163,6568081,6148918
Georgia,2012,M04,8.8,420315,4761357,4341042
New Hampshire,2008,M12,4.5,33239,740473,707234
California,2008,M09,7.7,1397892,18271189,16873297
North Carolina,2002,M08,6.4,269226,4190673,3921447
Colorado,2010,M02,8.9,241842,2707428,2465586
Indiana,2014,M08,5.9,190207,3231152,3040945
Rhode Island,2015,M07,6.0,33944,561136,527192
Puerto Rico,2015,M02,11.2,126545,1127172,1000627
New York,2005,M11,5.1,483175,9501747,9018572
New Hampshire,2009,M06,6.5,49123,753376,704253
Vermont,2008,M11,4.9,17346,356731,339385
Wyoming,2010,M07,5.6,17261,306184,288923
Alabama,2004,M09,5.6,119043,2134146,2015103
North Dakota,2009,M03,5.0,18096,365506,347410
District of Columbia,2011,M03,10.0,34823,349530,314707
New Jersey,2004,M11,4.0,175367,4339692,4164325
Rhode Island,2000,M02,4.8,26019,539591,513572
New Jersey,2011,M11,8.8,402088,4566790,4164702
Tennessee,2001,M04,3.9,110824,2840483,2729659
Georgia,2016,M12,5.2,258411,4981511,4723100
South Dakota,2003,M01,4.0,16578,413063,396485
Wisconsin,2008,M07,4.7,146675,3135749,2989074
Alaska,2003,M12,8.0,26271,329858,303587
Maine,2000,M09,2.7,18338,675138,656800
Ohio,2004,M10,6.0,353240,5901733,5548493
Wyoming,2008,M06,3.0,8815,298014,289199
Oregon,2004,M04,7.5,137414,1833717,1696303
Utah,2009,M08,7.7,104786,1369268,1264482
California,2004,M03,7.0,1210036,17352884,16142848
New Jersey,2003,M10,5.4,232841,4338996,4106155
Puerto Rico,2003,M11,12.0,161122,1338807,1177685
Florida,2003,M10,4.9,406203,8258354,7852151
Arizona,2001,M12,5.3,139257,2634321,2495064
Nebraska,2009,M12,4.7,46063,984149,938086
Connecticut,2009,M09,8.3,156116,1889162,1733046
Missouri,2006,M11,4.6,141041,3052855,2911814
Wyoming,2006,M01,4.1,11277,275728,264451
Ohio,2001,M10,4.4,258157,5842305,5584148
West Virginia,2001,M09,4.2,33989,808505,774516
Oklahoma,2007,M09,3.9,67185,1726824,1659639
Kentucky,2002,M09,5.2,100702,1942051,1841349
North Carolina,2010,M03,11.5,530778,4603654,4072876
Illinois,2004,M07,6.3,405793,6412245,6006452
Nevada,2000,M02,4.2,44324,1047093,1002769
Idaho,2016,M03,4.4,35407,806071,770664
Massachusetts,2004,M11,4.5,151375,3384783,3233408
Vermont,2015,M11,3.2,10911,343719,332808
Louisiana,2011,M08,8.1,167588,2080994,1913406
District of Columbia,2004,M04,6.9,21267,306942,285675
North Dakota,2000,M03,3.8,12988,338494,325506
New Mexico,2010,M08,8.4,78984,939690,860706
Washington,2008,M07,5.2,183553,3511200,3327647
Rhode Island,2007,M06,4.8,27397,576633,549236
New Jersey,2007,M11,4.0,176794,4461122,4284328
Texas,2010,M02,8.4,1012252,12067813,11055561
Connecticut,2016,M12,3.9,73548,1875808,1802260
New Hampshire,2008,M04,3.7,27453,736116,708663
Hawaii,2011,M02,6.7,44008,660684,616676
Wisconsin,2016,M01,4.7,144473,3084452,2939979
Rhode Island,2008,M05,7.1,40311,566163,525852
Nebraska,2002,M09,3.4,31811,947373,915562
Colorado,2002,M12,5.6,137195,2448586,2311391
Wyoming,2011,M06,5.5,17063,310674,293611
South Carolina,2005,M02,7.2,146155,2036460,1890305
Michigan,2010,M05,12.6,609496,4841955,4232459
Ohio,2007,M12,5.6,335509,5977480,5641971
Nevada,2013,M06,9.9,137104,1388328,1251224
District of Columbia,2010,M08,9.4,32420,346083,313663
Connecticut,2006,M02,4.8,87311,1800865,1713554
Massachusetts,2001,M03,3.6,121740,3366568,3244828
Virginia,2010,M03,7.7,317005,4125312,3808307
Louisiana,2016,M03,6.0,128087,2127347,1999260
Mississippi,2004,M03,5.5,71878,1304258,1232380
Iowa,2004,M07,4.2,68495,1621447,1552952
Alaska,2015,M10,6.1,22001,360163,338162
Nebraska,2007,M08,2.9,28091,983227,955136
Montana,2009,M02,7.7,38382,499125,460743
Washington,2013,M05,6.9,239574,3459932,3220358
North Carolina,2003,M03,6.3,267971,4243220,3975249
Iowa,2013,M09,4.3,72448,1682767,1610319
South Dakota,2000,M12,2.6,10557,404766,394209
Wyoming,2004,M10,3.4,9468,275072,265604
Kentucky,2011,M06,9.7,201427,2079636,1878209
Washington,2004,M12,5.9,190381,3226695,3036314
Massachusetts,2007,M11,4.1,142373,3436799,3294426
District of Columbia,2008,M11,7.5,24813,330635,305822
Louisiana,2005,M02,5.7,115257,2025959,1910702
Georgia,2014,M04,6.6,312432,4723715,4411283
Wisconsin,2011,M12,6.9,210205,3062217,2852012
Connecticut,2000,M06,2.5,44622,1785503,1740881
Indiana,2012,M08,8.4,265065,3163590,2898525
New Jersey,2013,M05,8.4,382266,4553141,4170875
Hawaii,2003,M10,4.2,25075,599793,574718
Alaska,2016,M06,6.8,24922,367755,342833
New Hampshire,2001,M09,3.7,25761,695251,669490
New Mexico,2016,M05,6.4,58612,919658,861046
New Mexico,2006,M06,5.0,46950,938403,891453
District of Columbia,2008,M01,6.1,19793,325280,305487
Minnesota,2005,M06,4.0,116368,2898633,2782265
Montana,2002,M01,5.5,25443,460663,435220
Maryland,2007,M03,3.4,101162,2951267,2850105
Rhode Island,2003,M10,4.7,26342,559937,533595
Idaho,2000,M06,4.2,28145,668386,640241
Arkansas,2002,M11,5.0,62921,1268487,1205566
Idaho,2007,M04,3.2,23815,750094,726279
Vermont,2014,M08,3.8,13225,351115,337890
Puerto Rico,2016,M05,11.3,127305,1130852,1003547
West Virginia,2006,M05,5.0,40440,808465,768025
Arizona,2006,M10,3.9,119324,3038625,2919301
Oklahoma,2000,M05,3.1,51249,1654770,1603521
Tennessee,2011,M02,9.8,305044,3108572,2803528
Missouri,2011,M08,8.8,268178,3048252,2780074
California,2002,M08,6.7,1151628,17311980,16160352
Maryland,2003,M05,4.4,125201,2874847,2749646
South Dakota,2010,M03,5.9,26079,439974,413895
Colorado,2002,M07,5.5,135827,2465209,2329382
California,2000,M03,5.4,911503,16806087,15894584
Louisiana,2009,M11,6.7,137760,2063525,1925765
Michigan,2016,M04,4.5,217050,4786552,4569502
District of Columbia,2006,M04,5.2,16257,310838,294581
New Mexico,2010,M05,8.1,75441,935364,859923
North Carolina,2008,M07,6.3,289018,4613181,4324163
Hawaii,2000,M04,4.2,25236,607535,582299
Vermont,2008,M03,5.1,18008,352085,334077
Pennsylvania,2013,M03,7.7,496360,6412277,5915917
Mississippi,2005,M07,6.9,92788,1336041,1243253
Iowa,2012,M12,5.0,82028,1649825,1567797
Texas,2003,M08,6.9,750831,10905382,10154551
North Dakota,2001,M09,2.2,7326,339715,332389
North Dakota,2010,M06,4.1,15830,388072,372242
Minnesota,2001,M01,4.1,116273,2816783,2700510
Minnesota,2006,M06,3.8,110230,2903459,2793229
Massachusetts,2004,M08,4.8,166091,3431087,3264996
Idaho,2007,M06,2.4,18275,765646,747371
Maryland,2012,M03,7.0,216884,3099581,2882697
North Dakota,2013,M12,2.8,11122,403897,392775
Maine,2016,M01,4.6,31061,672505,641444
Michigan,2014,M03,8.3,397244,4758681,4361437
Washington,2006,M09,4.7,155441,3328986,3173545
California,2010,M01,12.7,2315237,18178352,15863115
Virginia,2014,M07,5.6,238978,4298142,4059164
Iowa,2000,M05,2.3,36274,1582127,1545853
Kentucky,2001,M01,5.2,101350,1956079,1854729
Nebraska,2001,M12,3.2,30759,947324,916565
Washington,2014,M06,5.8,202586,3493360,3290774
Massachusetts,2013,M01,7.6,265190,3482954,3217764
Tennessee,2005,M07,5.5,160045,2933775,2773730
Vermont,2001,M03,3.7,12328,333885,321557
Mississippi,2005,M02,7.0,92378,1316156,1223778
Delaware,2014,M05,5.6,25205,449943,424738
Florida,2006,M03,2.9,256666,8874159,8617493
Vermont,2009,M10,5.5,19751,357717,337966
Nevada,2007,M08,4.5,60625,1333981,1273356
Delaware,2015,M09,4.8,22182,466322,444140
South Dakota,2001,M04,3.0,12132,409895,397763
Massachusetts,2009,M01,7.9,273038,3445811,3172773
Missouri,2015,M09,4.3,131446,3072376,2940930
Montana,2016,M03,4.9,25582,522197,496615
Montana,2002,M05,3.9,18040,466803,448763
Minnesota,2012,M03,6.5,189604,2931786,2742182
Delaware,2001,M11,3.1,12881,421526,408645
Nebraska,2016,M12,3.2,31903,1007426,975523
New Mexico,2013,M07,7.5,69765,926352,856587
Maryland,2006,M09,3.8,112615,2968893,2856278
Michigan,2005,M03,7.5,377498,5050522,4673024
Missouri,2000,M04,3.0,89562,2958764,2869202
California,2011,M02,12.2,2243773,18326409,16082636
New Jersey,2009,M02,8.6,390680,4530299,4139619
Texas,2003,M03,6.6,722674,10868315,10145641
Washington,2013,M06,7.0,244731,3483843,3239112
Nebraska,2005,M06,4.0,39329,985071,945742
Rhode Island,2005,M09,4.6,26266,568384,542118
Idaho,2005,M12,3.6,26702,735269,708567
District of Columbia,2005,M11,5.7,17990,313054,295064
Michigan,2006,M01,7.2,361486,5027079,4665593
Hawaii,2002,M03,4.5,27042,602535,575493
South Dakota,2008,M12,3.9,17504,444659,427155
Indiana,2009,M11,10.1,318350,3153153,2834803
Colorado,2013,M12,5.9,163189,2767507,2604318
Washington,2000,M08,5.2,158715,3058578,2899863
Nebraska,2003,M01,4.4,41443,952043,910600
Louisiana,2012,M02,7.3,148491,2042105,1893614
North Dakota,2009,M10,3.2,11639,367411,355772
Iowa,2004,M01,5.3,84830,1590003,1505173
Connecticut,2015,M02,6.5,122784,1879810,1757026
New York,2010,M01,9.6,913397,9546265,8632868
Florida,2002,M07,6.0,487998,8161313,7673315
Michigan,2012,M01,9.7,448321,4614170,4165849
Texas,2011,M12,6.9,870603,12585464,11714861
California,2001,M05,4.6,782863,17013740,16230877
Puerto Rico,2010,M06,16.9,215460,1271923,1056463
Rhode Island,2013,M04,9.0,49465,550720,501255
Utah,2002,M12,5.4,64559,1188155,1123596
South Dakota,2016,M08,2.7,12510,458179,445669
New Mexico,2012,M08,7.3,67298,924501,857203
Tennessee,2001,M06,4.4,127005,2873863,2746858
Indiana,2012,M03,8.6,272469,3156132,2883663
West Virginia,2015,M07,7.0,55536,794186,738650
Oklahoma,2009,M07,6.4,115087,1784321,1669234
Massachusetts,2001,M04,3.2,108562,3349943,3241381
Texas,2010,M03,8.3,1001101,12128185,11127084
North Carolina,2006,M06,5.0,222631,4470318,4247687
Utah,2007,M06,2.9,39349,1369073,1329724
South Carolina,2009,M05,11.1,240131,2168324,1928193
Vermont,2009,M01,6.8,24503,358066,333563
Hawaii,2011,M03,6.6,43533,663479,619946
Mississippi,2001,M06,5.8,74951,1303062,1228111
Iowa,2001,M01,3.9,62004,1594134,1532130
Florida,2004,M01,4.9,401164,8268302,7867138
Kansas,2011,M04,6.3,93668,1484472,1390804
Maine,2012,M12,7.1,50098,700681,650583
Virginia,2000,M06,2.4,88922,3632726,3543804
Indiana,2013,M08,7.3,233279,3199818,2966539
Kentucky,2008,M02,6.2,123636,2003266,1879630
Indiana,2010,M11,9.6,301817,3158560,2856743
New Hampshire,2002,M06,4.5,31798,709120,677322
Washington,2016,M02,6.1,221553,3608103,3386550
Tennessee,2009,M12,10.3,310397,3022589,2712192
South Carolina,2009,M04,10.7,231231,2158919,1927688
Idaho,2014,M11,4.5,35470,782116,746646
Arkansas,2011,M10,7.5,102316,1366668,1264352
Puerto Rico,2011,M09,15.6,188157,1209701,1021544
California,2009,M02,10.6,1935243,18275129,16339886
Illinois,2012,M03,9.0,588345,6534768,5946423
Wyoming,2012,M09,4.7,14290,306748,292458
Maryland,2010,M07,7.8,245281,3131098,2885817
New Jersey,2015,M02,6.9,312365,4529547,4217182
Rhode Island,2008,M01,7.2,41120,569919,528799
Missouri,2003,M07,6.0,182190,3047220,2865030
Utah,2004,M06,5.4,67204,1239021,1171817
District of Columbia,2001,M06,6.8,21423,314925,293502
Virginia,2009,M08,6.9,284098,4125980,3841882
Kentucky,2003,M04,6.0,116885,1954521,1837636
Alaska,2015,M11,6.5,23265,358575,335310
Mississippi,2007,M01,6.9,88289,1286772,1198483
Maine,2002,M10,3.9,26474,681735,655261
Puerto Rico,2001,M06,11.4,146039,1281857,1135818
California,2016,M08,5.6,1069094,19178340,18109246
Michigan,2000,M04,2.9,149895,5130882,4980987
Puerto Rico,2012,M12,13.6,162049,1188357,1026308
Wisconsin,2007,M11,4.2,129256,3086014,2956758
Maine,2015,M10,3.5,23864,682854,658990
Wisconsin,2000,M11,3.2,95879,2978290,2882411
New Hampshire,2001,M06,3.3,23249,705500,682251
Delaware,2008,M02,4.4,19720,444861,425141
Connecticut,2013,M02,8.5,157764,1849780,1692016
Oregon,2001,M07,6.2,113661,1841312,1727651
Oregon,2010,M06,10.6,211982,1993202,1781220
Vermont,2000,M12,2.6,8525,333593,325068
Idaho,2010,M11,8.7,65952,758058,692106
Washington,2004,M08,5.8,186593,3205972,3019379
Iowa,2004,M05,4.1,65046,1591027,1525981
Utah,2008,M10,3.5,48463,1373079,1324616
South Dakota,2000,M08,2.3,9486,413043,403557
Ohio,2009,M09,10.3,602544,5865419,5262875
Delaware,2002,M05,3.8,15872,416421,400549
Nebraska,2006,M02,3.5,33806,962516,928710
District of Columbia,2000,M04,4.7,14224,305811,291587
Ohio,2006,M10,4.8,287153,5990664,5703511
Texas,2011,M09,7.9,989432,12596771,11607339
New Jersey,2001,M10,4.5,195041,4310962,4115921
Georgia,2013,M09,7.9,375228,4748061,4372833
Arizona,2010,M02,10.7,331045,3105393,2774348
North Dakota,2015,M07,2.6,11032,421234,410202
Hawaii,2010,M09,7.1,46189,649188,602999
District of Columbia,2009,M07,9.6,33098,344905,311807
Colorado,2016,M02,3.9,110856,2870746,2759890
Idaho,2010,M02,10.4,78518,757205,678687
Oregon,2009,M02,12.1,239612,1982288,1742676
Illinois,2006,M08,4.5,299279,6594827,6295548
North Carolina,2001,M01,4.9,203732,4185763,3982031
Vermont,2012,M12,4.4,15337,351835,336498
West Virginia,2001,M10,4.2,34073,807555,773482
Kentucky,2006,M07,6.0,122409,2046361,1923952
Oklahoma,2007,M10,3.8,66072,1731565,1665493
Rhode Island,2015,M06,5.8,32202,557904,525702
Minnesota,2014,M04,4.3,127715,2948315,2820600
Nevada,2001,M06,5.0,55316,1113451,1058135
Iowa,2009,M02,6.9,115872,1687681,1571809
Washington,2001,M02,6.6,200764,3048938,2848174
Vermont,2001,M02,3.6,12018,333688,321670
Connecticut,2003,M07,5.7,104296,1815395,1711099
Mississippi,2000,M03,5.7,74890,1323048,1248158
South Carolina,2001,M09,5.5,106572,1940056,1833484
Kansas,2011,M02,7.2,107424,1491190,1383766
Georgia,2002,M12,4.9,216111,4382784,4166673
Nevada,2003,M07,5.2,60398,1151501,1091103
South Dakota,2003,M12,3.7,15400,421541,406141
Louisiana,2000,M07,5.7,116933,2060188,1943255
North Carolina,2007,M03,4.4,198903,4487643,4288740
Missouri,2009,M05,9.0,273912,3060317,2786405
Illinois,2008,M03,5.7,380329,6664482,6284153
West Virginia,2013,M04,6.6,52713,799197,746484
Oklahoma,2011,M04,5.3,92783,1760666,1667883
Tennessee,2000,M07,3.9,112393,2853454,2741061
Georgia,2014,M08,7.7,364999,4758661,4393662
California,2009,M11,11.7,2127225,18174664,16047439
North Dakota,2002,M12,3.8,12620,335359,322739
Kansas,2014,M11,3.9,58007,1495040,1437033
California,2014,M11,7.0,1313238,18869435,17556197
Wyoming,2003,M10,3.6,9990,274683,264693
Minnesota,2012,M02,6.6,192289,2925227,2732938
Arizona,2000,M12,3.5,88374,2543913,2455539
Maryland,2014,M10,5.4,171099,3139832,2968733
New Mexico,2010,M06,9.0,85751,949623,863872
Nevada,2000,M11,4.4,47669,1087747,1040078
Indiana,2002,M10,4.5,142661,3181589,3038928
Missouri,2007,M10,5.0,152625,3032130,2879505
Wyoming,2006,M10,2.8,8003,283056,275053
Puerto Rico,2011,M10,16.5,201097,1218429,1017332
Washington,2010,M07,9.5,335591,3531665,3196074
North Dakota,2016,M04,3.4,14068,413236,399168
Idaho,2010,M07,8.3,63850,769888,706038
South Dakota,2014,M03,4.1,18264,445025,426761
Tennessee,2005,M05,5.5,158733,2890369,2731636
Texas,2008,M05,4.4,506759,11603854,11097095
Rhode Island,2011,M05,10.7,59363,555847,496484
Minnesota,2013,M06,5.1,153436,2980432,2826996
California,2012,M03,11.0,2034002,18468013,16434011
Ohio,2008,M12,7.7,457273,5918450,5461177
New York,2002,M07,6.1,570602,9390002,8819400
Wisconsin,2005,M05,4.5,135623,3001188,2865565
Oregon,2013,M08,7.6,147043,1926536,1779493
Rhode Island,2006,M02,5.8,32774,566947,534173
Maine,2009,M10,7.3,50919,695741,644822
Alabama,2015,M12,5.9,127389,2158154,2030765
New Mexico,2007,M02,3.8,34996,926847,891851
Arkansas,2002,M06,5.8,74496,1295316,1220820
Wyoming,2016,M10,4.5,13436,300979,287543
Idaho,2005,M11,3.6,26220,734912,708692
Puerto Rico,2014,M05,13.7,153979,1126961,972982
Alabama,2003,M08,6.4,135588,2119418,1983830
New Mexico,2009,M06,8.7,82628,951935,869307
New York,2012,M12,8.1,780531,9607545,8827014
West Virginia,2012,M03,7.8,62353,798965,736612
Oklahoma,2010,M03,7.0,122261,1754215,1631954
Alabama,2011,M02,10.5,232117,2204837,1972720
Pennsylvania,2015,M06,5.6,361211,6498014,6136803
Texas,2016,M12,4.5,605992,13353321,12747329
Alaska,2004,M09,6.5,21998,338673,316675
District of Columbia,2013,M09,8.6,31944,370544,338600
Idaho,2014,M12,4.3,33949,780772,746823
Georgia,2004,M01,4.5,200370,4407494,4207124
Mississippi,2012,M10,8.8,115775,1311500,1195725
Rhode Island,2015,M04,5.9,32249,549194,516945
Minnesota,2014,M06,4.2,125126,2983022,2857896
Maine,2004,M07,4.3,29987,703821,673834
Puerto Rico,2007,M12,10.8,145821,1347027,1201206
Michigan,2007,M04,6.6,326628,4963443,4636815
Mississippi,2001,M09,5.4,69517,1279602,1210085
Georgia,2009,M04,9.0,430540,4767123,4336583
Puerto Rico,2005,M05,10.9,150748,1380914,1230166
Arkansas,2001,M06,5.2,66747,1274874,1208127
Georgia,2000,M08,3.9,164397,4225059,4060662
West Virginia,2014,M11,5.9,45772,779068,733296
New Hampshire,2013,M02,5.9,43942,740639,696697
North Carolina,2006,M09,4.6,205087,4477962,4272875
Arkansas,2014,M01,7.4,93972,1274507,1180535
Oklahoma,2008,M11,4.1,72889,1770129,1697240
Pennsylvania,2006,M04,4.4,272222,6237982,5965760
Hawaii,2016,M10,2.9,20269,687426,667157
Idaho,2001,M11,5.3,35837,679740,643903
Florida,2002,M03,5.6,454974,8069414,7614440
Pennsylvania,2008,M11,5.7,367513,6475296,6107783
Arkansas,2006,M05,5.2,71397,1370820,1299423
Utah,2005,M12,3.3,42973,1291647,1248674
Utah,2014,M07,4.0,57780,1438471,1380691
Maryland,2001,M12,4.3,122811,2851777,2728966
Georgia,2012,M08,9.4,449040,4771374,4322334
Michigan,2014,M07,8.4,407794,4829983,4422189
Illinois,2009,M05,9.9,659908,6634113,5974205
Kansas,2016,M07,4.8,72640,1502871,1430231
Michigan,2001,M03,5.4,277526,5171952,4894426
Mississippi,2013,M07,9.0,115847,1282227,1166380
New Jersey,2008,M09,5.4,243011,4488387,4245376
Iowa,2013,M12,4.4,74594,1682864,1608270
Michigan,2012,M09,8.3,388960,4666169,4277209
New Hampshire,2004,M03,4.4,31511,711685,680174
Maine,2003,M12,4.8,32444,680867,648423
Nevada,2015,M09,6.6,93825,1417176,1323351
California,2001,M06,5.2,895164,17103247,16208083
Nevada,2002,M06,5.7,64264,1130135,1065871
Ohio,2010,M08,9.8,577175,5890030,5312855
Iowa,2001,M07,2.9,47258,1629448,1582190
Montana,2006,M04,3.7,18416,492079,473663
Louisiana,2002,M12,6.0,118776,1995943,1877167
Colorado,2001,M09,4.0,96713,2412571,2315858
Nebraska,2002,M12,3.5,33510,952594,919084
Kentucky,2016,M09,4.8,96448,2000277,1903829
Indiana,2001,M05,3.6,113805,3134365,3020560
Kansas,2006,M07,4.8,70764,1486996,1416232
Connecticut,2005,M04,4.8,85574,1779106,1693532
Florida,2004,M09,4.7,403380,8507718,8104338
Maine,2011,M11,7.5,51925,696882,644957
New Jersey,2015,M08,5.5,249063,4537410,4288347
New Hampshire,2006,M08,3.3,24776,742330,717554
Vermont,2007,M08,3.7,13046,356060,343014
Tennessee,2007,M10,4.8,145648,3063240,2917592
Georgia,2011,M10,10.1,484027,4783544,4299517
Minnesota,2007,M12,4.8,138488,2902776,2764288
Alabama,2001,M08,5.6,118389,2108846,1990457
Alaska,2010,M01,8.9,31605,356118,324513
Missouri,2002,M08,5.4,160345,2991633,2831288
New Mexico,2000,M11,4.6,39540,856706,817166
Montana,2003,M03,5.5,25472,466299,440827
Utah,2002,M03,5.9,69439,1171955,1102516
Alaska,2008,M07,6.0,22082,367756,345674
New Jersey,2003,M08,5.7,250426,4365605,4115179
Puerto Rico,2012,M08,14.4,170495,1181932,1011437
North Dakota,2011,M10,2.7,10506,391384,380878
Delaware,2003,M02,4.9,20088,410706,390618
Mississippi,2005,M06,7.4,99487,1336696,1237209
Maryland,2000,M05,3.6,100247,2793437,2693190
Puerto Rico,2002,M06,12.9,173263,1342171,1168908
Iowa,2005,M01,5.4,87094,1602992,1515898
Minnesota,2006,M02,4.9,141689,2873905,2732216
District of Columbia,2016,M04,5.4,21130,391221,370091
Idaho,2002,M04,6.1,41387,680477,639090
North Carolina,2014,M06,6.5,305647,4704748,4399101
Utah,2015,M06,4.0,58843,1473404,1414561
Alabama,2008,M01,4.8,104650,2170233,2065583
South Carolina,2005,M04,6.1,126271,2053936,1927665
Pennsylvania,2008,M07,5.5,361251,6562471,6201220
Montana,2016,M11,3.8,19879,524923,505044
Louisiana,2001,M08,5.9,119750,2020693,1900943
Connecticut,2006,M07,4.7,87974,1862869,1774895
Wisconsin,2001,M05,4.1,123362,2995906,2872544
Tennessee,2012,M09,7.4,228954,3095649,2866695
California,2016,M01,5.9,1112542,18916318,17803776
Indiana,2006,M08,5.1,166469,3245635,3079166
Louisiana,2015,M07,6.7,146356,2191168,2044812
Delaware,2002,M04,4.2,17671,419028,401357
Virginia,2008,M10,4.0,167538,4154363,3986825
Oregon,2002,M10,6.7,124321,1844713,1720392
Florida,2004,M06,5.0,421886,8458578,8036692
Maine,2005,M06,4.7,33218,707196,673978
Puerto Rico,2005,M06,11.8,166625,1414211,1247586
Georgia,2016,M10,5.6,276234,4972208,4695974
Minnesota,2009,M09,7.5,220789,2930310,2709521
West Virginia,2004,M05,5.3,41821,786116,744295
Oklahoma,2002,M05,4.6,77422,1690877,1613455
District of Columbia,2006,M05,5.6,17413,312489,295076
Virginia,2013,M10,5.7,239523,4213120,3973597
North Carolina,2006,M08,5.0,223395,4489051,4265656
Wyoming,2004,M08,3.3,9235,277987,268752
Connecticut,2007,M04,4.0,73918,1832720,1758802
Virginia,2002,M09,3.9,146542,3744648,3598106
California,2002,M12,6.7,1150804,17260482,16109678
Utah,2012,M06,5.7,79294,1382362,1303068
Mississippi,2003,M04,6.0,77116,1289262,1212146
Delaware,2003,M07,4.5,18818,420172,401354
Arkansas,2016,M05,3.9,52655,1348027,1295372
Kansas,2005,M12,4.3,63527,1460592,1397065
Kansas,2000,M02,3.6,50198,1412074,1361876
Pennsylvania,2004,M09,4.9,302696,6200930,5898234
Utah,2001,M08,4.8,56537,1172632,1116095
Puerto Rico,2011,M11,15.4,187576,1214929,1027353
Texas,2015,M02,4.4,574706,12979236,12404530
Puerto Rico,2013,M03,13.5,156450,1160434,1003984
Michigan,2001,M11,5.7,287043,5068515,4781472
Virginia,2013,M01,6.4,269659,4210542,3940883
Puerto Rico,2014,M04,13.4,152160,1131537,979377
Maine,2006,M06,4.4,31468,710686,679218
Montana,2002,M09,3.5,16411,466637,450226
Vermont,2007,M11,3.8,13367,351144,337777
Utah,2011,M02,7.9,106447,1347431,1240984
Massachusetts,2016,M09,3.3,119229,3568057,3448828
Florida,2012,M05,8.4,792119,9426566,8634447
New Jersey,2015,M11,4.7,212993,4508131,4295138
Nebraska,2009,M11,4.3,42135,987811,945676
South Carolina,2008,M04,5.2,111086,2125668,2014582
Puerto Rico,2016,M10,12.5,137831,1102730,964899
Illinois,2013,M05,8.8,577258,6550882,5973624
District of Columbia,2003,M01,6.9,20682,301382,280700
West Virginia,2013,M01,8.3,65825,796379,730554
Oklahoma,2011,M01,6.6,115468,1750040,1634572
Kansas,2007,M06,4.4,65867,1502750,1436883
Michigan,2007,M05,6.7,334264,5015433,4681169
Ohio,2015,M12,4.7,268825,5679381,5410556
Vermont,2000,M09,2.7,8921,331913,322992
California,2005,M12,4.9,866141,17551112,16684971
Puerto Rico,2008,M11,12.7,171861,1349853,1177992
Kansas,2010,M09,6.8,102192,1495312,1393120
District of Columbia,2001,M02,6.3,19618,310285,290667
Tennessee,2013,M03,8.0,245623,3071833,2826210
South Dakota,2000,M06,2.4,9958,417408,407450
Texas,2016,M08,4.9,656216,13295171,12638955
Pennsylvania,2016,M12,4.8,306757,6395720,6088963
Massachusetts,2015,M11,4.3,152636,3584252,3431616
Nevada,2009,M06,11.5,155062,1351393,1196331
District of Columbia,2006,M08,5.9,18734,318325,299591
Minnesota,2009,M08,7.7,227260,2958446,2731186
Oregon,2001,M06,6.1,111253,1832688,1721435
West Virginia,2009,M06,8.4,69274,829437,760163
Oklahoma,2015,M06,4.9,90153,1854443,1764290
Vermont,2012,M04,5.2,18406,350884,332478
Texas,2007,M05,4.0,449863,11353324,10903461
Pennsylvania,2007,M05,4.2,262365,6307108,6044743
Minnesota,2000,M12,3.1,88496,2824329,2735833
North Carolina,2001,M06,5.4,226247,4213029,3986782
Idaho,2006,M10,2.5,18517,748909,730392
Delaware,2004,M12,3.6,15374,421705,406331
Connecticut,2010,M08,9.3,181227,1939623,1758396
North Dakota,2004,M05,3.0,10442,353063,342621
Kansas,2004,M06,5.6,83462,1483146,1399684
Rhode Island,2004,M03,5.8,32368,553577,521209
Hawaii,2016,M04,3.0,20394,681793,661399
New Jersey,2005,M02,5.1,219316,4341298,4121982
Florida,2007,M07,4.4,409948,9239296,8829348
Maine,2007,M01,5.2,36170,694901,658731
Idaho,2013,M05,5.8,44519,771358,726839
Georgia,2007,M01,4.5,217051,4773200,4556149
New Mexico,2002,M06,6.4,56225,882939,826714
Maryland,2012,M10,6.7,211696,3136818,2925122
District of Columbia,2014,M01,8.1,30071,370451,340380
District of Columbia,2001,M07,6.7,21418,319592,298174
Utah,2005,M08,4.0,51348,1287323,1235975
Colorado,2011,M02,9.1,247618,2713970,2466352
Missouri,2016,M09,4.6,141820,3108513,2966693
Tennessee,2003,M04,5.3,153206,2909984,2756778
Kentucky,2010,M10,9.4,192069,2045601,1853532
Delaware,2006,M06,3.8,16684,444817,428133
Ohio,2016,M10,4.7,268016,5722196,5454180
Mississippi,2016,M04,5.2,65405,1268078,1202673
South Carolina,2010,M04,10.9,234476,2157570,1923094
California,2014,M08,7.6,1429944,18815295,17385351
Connecticut,2001,M10,2.8,48837,1757360,1708523
Georgia,2014,M06,7.6,364238,4771637,4407399
Illinois,2000,M12,4.4,286589,6478104,6191515
New York,2016,M11,4.5,428310,9496305,9067995
West Virginia,2008,M03,5.0,40030,807302,767272
Oklahoma,2014,M03,4.8,85344,1784238,1698894
New Jersey,2013,M07,8.6,395906,4600633,4204727
South Carolina,2013,M10,7.1,155536,2191049,2035513
Arizona,2005,M04,4.6,130791,2855404,2724613
Maryland,2004,M02,4.6,130725,2857964,2727239
Hawaii,2004,M04,3.3,20277,609399,589122
North Dakota,2005,M12,3.3,11693,352616,340923
Minnesota,2002,M10,3.6,103979,2861358,2757379
Alabama,2007,M09,4.0,87960,2174850,2086890
New Mexico,2001,M06,5.5,47879,865402,817523
Arkansas,2007,M07,5.9,81584,1388155,1306571
Alaska,2003,M07,7.1,24224,341583,317359
District of Columbia,2009,M02,8.5,28335,333423,305088
Minnesota,2007,M08,4.3,124869,2920573,2795704
Illinois,2005,M09,5.4,345669,6403292,6057623
Idaho,2003,M10,4.8,32860,690656,657796
Wyoming,2013,M03,5.4,16313,304385,288072
Maine,2015,M09,3.5,23869,680549,656680
Tennessee,2015,M08,5.6,170659,3064906,2894247
Georgia,2013,M06,9.0,429978,4793990,4364012
Louisiana,2009,M09,7.1,145735,2055631,1909896
Mississippi,2002,M10,6.5,83603,1288889,1205286
West Virginia,2016,M02,7.5,58854,780879,722025
Idaho,2016,M02,4.6,36623,802960,766337
Connecticut,2010,M09,9.0,172477,1916032,1743555
Alabama,2003,M06,6.9,146681,2136319,1989638
West Virginia,2014,M09,5.9,46598,786872,740274
Oklahoma,2008,M09,3.7,65530,1758074,1692544
Kentucky,2005,M09,5.4,108370,2001819,1893449
New Mexico,2011,M10,7.4,68797,933019,864222
Montana,2015,M05,3.6,18839,519149,500310
North Carolina,2016,M02,5.3,255584,4837668,4582084
South Dakota,2007,M11,2.5,11043,443157,432114
Missouri,2001,M01,5.0,150985,3009716,2858731
North Dakota,2015,M04,2.8,11709,413001,401292
Wyoming,2016,M01,6.0,17939,300160,282221
Iowa,2004,M04,4.2,66786,1591139,1524353
Oregon,2010,M09,9.7,192749,1991737,1798988
New Mexico,2005,M05,5.0,45753,911651,865898
Nevada,2006,M06,4.2,54309,1288551,1234242
Vermont,2000,M08,2.6,8780,335639,326859
Nebraska,2001,M09,2.9,27484,942822,915338
Iowa,2007,M12,3.8,63540,1664936,1601396
Louisiana,2016,M01,6.4,136134,2111622,1975488
Arizona,2009,M09,11.0,344927,3138175,2793248
Oregon,2012,M01,9.8,192985,1962542,1769557
Colorado,2005,M12,4.7,120283,2585186,2464903
Nevada,2008,M07,6.7,92102,1373451,1281349
Delaware,2002,M10,3.7,15095,412880,397785
Delaware,2014,M07,5.9,27334,460032,432698
Indiana,2014,M02,6.9,221505,3187253,2965748
Puerto Rico,2015,M08,12.4,137328,1110573,973245
Washington,2009,M06,9.2,326529,3560592,3234063
Rhode Island,2005,M12,4.7,26880,570261,543381
Idaho,2005,M09,3.2,23562,735405,711843
Nevada,2010,M06,13.5,183759,1359001,1175242
Washington,2012,M08,7.9,274097,3466593,3192496
Pennsylvania,2016,M09,5.3,345629,6474896,6129267
Alaska,2014,M01,7.8,28037,361268,333231
Utah,2015,M05,3.6,53031,1461456,1408425
Louisiana,2006,M11,4.1,82294,2012514,1930220
Florida,2000,M02,3.5,274179,7758752,7484573
Maryland,2006,M12,3.5,103013,2968941,2865928
District of Columbia,2015,M02,7.7,29493,385428,355935
Maryland,2007,M10,3.3,96879,2975742,2878863
New Hampshire,2015,M03,4.0,29830,740704,710874
Puerto Rico,2004,M07,10.0,134291,1337067,1202776
New Hampshire,2002,M09,4.3,30313,701491,671178
Texas,2003,M05,6.6,718430,10875768,10157338
Nevada,2005,M10,3.9,48074,1240420,1192346
Oregon,2000,M03,5.7,102913,1809662,1706749
Michigan,2016,M12,4.5,215298,4830685,4615387
Connecticut,2007,M05,4.2,77802,1850520,1772718
Michigan,2002,M07,7.0,357226,5068379,4711153
Indiana,2013,M11,6.6,210969,3206879,2995910
Massachusetts,2004,M09,4.9,163859,3362296,3198437
Indiana,2002,M11,4.9,153976,3168005,3014029
Nebraska,2015,M03,3.1,31310,1003335,972025
Pennsylvania,2016,M11,4.9,312670,6439865,6127195
New Jersey,2004,M07,5.2,230867,4422480,4191613
Montana,2008,M02,5.3,26440,503521,477081
Massachusetts,2013,M04,6.5,228370,3488458,3260088
Utah,2003,M06,6.1,73507,1206862,1133355
Hawaii,2002,M05,4.2,25028,600365,575337
Massachusetts,2000,M12,2.4,80322,3341988,3261666
Alaska,2015,M08,5.5,20369,368155,347786
Indiana,2012,M10,7.8,249270,3183532,2934262
North Dakota,2013,M04,3.2,12910,404299,391389
Wyoming,2000,M07,3.4,9281,272210,262929
California,2001,M07,5.5,946952,17176912,16229960
Virginia,2014,M01,5.7,238951,4223768,3984817
Rhode Island,2001,M11,4.3,23271,545537,522266
New Jersey,2001,M01,4.2,178398,4249712,4071314
District of Columbia,2002,M09,6.3,19146,303630,284484
North Dakota,2014,M09,2.1,8870,417933,409063
Alaska,2011,M02,8.8,31843,361511,329668
Iowa,2010,M01,7.3,120860,1666883,1546023
Michigan,2014,M02,8.5,400276,4733119,4332843
Oregon,2011,M03,10.2,202693,1988437,1785744
Ohio,2016,M03,5.3,304346,5713377,5409031
Pennsylvania,2000,M02,4.7,284115,6056255,5772140
Florida,2009,M08,11.1,1012048,9127618,8115570
Virginia,2016,M10,4.0,170163,4258096,4087933
South Dakota,2007,M09,2.5,10942,441303,430361
Utah,2008,M11,3.6,49770,1367213,1317443
Hawaii,2005,M04,2.7,16982,624011,607029
Nebraska,2000,M03,3.0,27815,940748,912933
Michigan,2009,M05,14.2,702416,4962763,4260347
South Carolina,2009,M10,11.5,245972,2139678,1893706
Florida,2012,M06,8.9,841419,9436133,8594714
California,2013,M09,8.5,1579781,18668714,17088933
Maine,2013,M06,6.4,46213,718306,672093
Alaska,2004,M10,6.8,22971,337655,314684
Wyoming,2008,M02,3.4,9928,288225,278297
Delaware,2003,M11,3.5,14738,417602,402864
Rhode Island,2010,M04,11.2,63124,563390,500266
Washington,2016,M05,5.2,190151,3625231,3435080
Delaware,2004,M11,3.6,15098,421388,406290
Kansas,2016,M06,4.5,68046,1498331,1430285
Florida,2006,M02,3.1,269433,8817866,8548433
Pennsylvania,2005,M01,5.7,355464,6189809,5834345
New Hampshire,2005,M06,3.6,26040,732762,706722
South Carolina,2010,M05,10.7,232874,2168237,1935363
South Dakota,2011,M02,5.8,25141,436424,411283
Georgia,2009,M12,10.4,497163,4782579,4285416
Idaho,2011,M07,7.8,60580,775049,714469
Texas,2003,M10,6.3,688930,10942655,10253725
Delaware,2012,M09,7.2,31661,441133,409472
Texas,2007,M07,4.7,535176,11506600,10971424
Indiana,2006,M06,5.1,168205,3270217,3102012
District of Columbia,2004,M03,7.4,22810,307869,285059
Colorado,2009,M11,7.7,207644,2708781,2501137
North Carolina,2005,M02,6.0,253712,4258857,4005145
New York,2004,M09,5.2,486382,9332430,8846048
South Dakota,2004,M08,3.6,15559,433687,418128
Pennsylvania,2009,M01,7.8,500880,6436868,5935988
Pennsylvania,2000,M07,4.3,267272,6195106,5927834
Missouri,2012,M09,6.3,190049,3017354,2827305
Washington,2003,M03,8.0,247667,3109692,2862025
Vermont,2004,M02,4.5,15609,345976,330367
District of Columbia,2002,M06,6.7,20691,310285,289594
Maryland,2001,M09,4.2,118274,2839882,2721608
Mississippi,2002,M01,7.4,94427,1277919,1183492
New York,2007,M12,4.8,457213,9550419,9093206
Florida,2003,M06,5.8,480002,8253636,7773634
Maine,2014,M06,5.3,37577,707440,669863
Pennsylvania,2002,M08,5.4,341789,6271976,5930187
District of Columbia,2007,M01,5.9,18768,317298,298530
Vermont,2004,M12,3.3,11413,346851,335438
Hawaii,2016,M05,3.0,20261,681018,660757
Oregon,2001,M05,5.6,102054,1811494,1709440
New Jersey,2000,M11,3.5,149826,4264405,4114579
Pennsylvania,2007,M06,4.5,290310,6401320,6111010
Ohio,2013,M02,8.3,470970,5666687,5195717
Mississippi,2006,M08,6.2,79430,1284454,1205024
Florida,2011,M09,9.9,934233,9390032,8455799
South Dakota,2016,M02,3.3,14734,446985,432251
Indiana,2004,M02,5.8,181541,3144246,2962705
Massachusetts,2015,M04,4.7,165525,3555917,3390392
South Dakota,2011,M12,4.5,19755,438400,418645
Delaware,2005,M01,4.6,19411,420842,401431
Wisconsin,2008,M02,5.5,167351,3069763,2902412
Connecticut,2009,M08,8.4,160839,1914858,1754019
Illinois,2002,M08,6.5,412418,6338604,5926186
Tennessee,2010,M02,10.8,329113,3050909,2721796
Nebraska,2014,M05,3.1,31995,1015792,983797
Kansas,2015,M06,4.6,68578,1504308,1435730
Maryland,2014,M12,5.2,161662,3120843,2959181
North Dakota,2015,M03,3.4,14120,412247,398127
Idaho,2012,M05,6.8,52386,769293,716907
Alaska,2013,M08,5.9,22054,371313,349259
Alabama,2004,M12,4.9,105756,2147095,2041339
Arkansas,2003,M03,5.9,74784,1263949,1189165
New York,2009,M02,8.3,798673,9664716,8866043
Mississippi,2004,M02,5.6,73532,1303674,1230142
Pennsylvania,2008,M02,5.3,334684,6354767,6020083
Arizona,2008,M12,7.8,245014,3136040,2891026
Colorado,2002,M02,5.7,138789,2423111,2284322
New Mexico,2008,M03,4.0,37880,935734,897854
Kansas,2007,M01,4.6,67706,1468345,1400639
Arizona,2016,M07,5.7,186236,3240274,3054038
New York,2011,M12,8.4,801667,9527694,8726027
Virginia,2001,M07,3.3,121172,3720545,3599373
Utah,2003,M05,5.6,66293,1192007,1125714
Rhode Island,2008,M03,7.2,40985,566590,525605
Iowa,2000,M09,2.3,37123,1582121,1544998
Virginia,2015,M03,4.8,202018,4223077,4021059
North Dakota,2002,M11,3.4,11561,336675,325114
North Carolina,2009,M06,10.8,498908,4601743,4102835
Illinois,2014,M05,6.9,445506,6491236,6045730
Massachusetts,2008,M12,6.6,227694,3465451,3237757
Connecticut,2003,M05,5.4,96334,1785949,1689615
Nevada,2000,M12,4.4,48224,1088453,1040229
Delaware,2001,M05,2.9,12255,419844,407589
Kansas,2012,M06,6.0,90179,1501491,1411312
North Carolina,2003,M02,6.7,282810,4232138,3949328
Louisiana,2000,M05,5.0,102757,2038001,1935244
Colorado,2006,M11,3.8,100959,2644869,2543910
Pennsylvania,2001,M03,4.8,297390,6160517,5863127
New Hampshire,2008,M10,3.5,26154,740001,713847
Puerto Rico,2008,M09,12.2,163428,1336233,1172805
Kansas,2010,M11,6.7,99768,1499765,1399997
Kansas,2009,M11,6.6,99929,1512263,1412334
Arizona,2004,M12,4.4,123763,2825610,2701847
Kentucky,2012,M05,8.0,164647,2063619,1898972
Alaska,2002,M05,7.2,23312,325745,302433
Missouri,2013,M03,7.0,210894,3004795,2793901
Michigan,2004,M03,7.8,393130,5044903,4651773
Indiana,2009,M09,10.0,315104,3156940,2841836
Wyoming,2011,M01,7.2,21891,303903,282012
Nevada,2016,M09,5.4,77259,1432348,1355089
Kansas,2006,M02,4.8,69487,1456436,1386949
Maryland,2000,M03,3.5,98161,2780874,2682713
Maryland,2005,M07,4.3,128648,2983355,2854707
Rhode Island,2001,M03,4.9,26209,540122,513913
Delaware,2001,M04,3.4,14153,421764,407611
Missouri,2000,M07,3.5,103800,2966589,2862789
Alaska,2016,M10,6.2,22232,357474,335242
Oregon,2007,M01,5.9,112112,1897874,1785762
Illinois,2001,M02,5.4,351163,6475282,6124119
Vermont,2003,M07,4.1,14327,350635,336308
Puerto Rico,2015,M12,10.3,117829,1140082,1022253
Texas,2008,M07,5.2,606120,11757651,11151531
Minnesota,2015,M04,3.6,108083,2966123,2858040
Vermont,2013,M03,4.9,17195,350967,333772
Pennsylvania,2010,M03,9.2,579804,6334926,5755122
Nebraska,2013,M07,4.2,42988,1035796,992808
Pennsylvania,2010,M02,9.5,602967,6318716,5715749
Colorado,2004,M02,6.1,153085,2506329,2353244
Idaho,2014,M05,4.5,34809,780297,745488
Wyoming,2001,M03,4.4,11665,267264,255599
Idaho,2009,M11,9.0,68445,756435,687990
Kansas,2001,M11,4.4,61350,1395435,1334085
Oregon,2006,M07,5.3,101086,1907866,1806780
New Mexico,2008,M01,4.1,37938,933086,895148
Kentucky,2009,M02,10.7,218212,2045601,1827389
Tennessee,2002,M12,5.0,144452,2914159,2769707
Missouri,2004,M03,6.0,181711,3008847,2827136
North Dakota,2012,M01,3.9,15276,387814,372538
Massachusetts,2003,M08,5.7,195356,3455248,3259892
Maryland,2009,M12,7.3,221887,3023000,2801113
Alabama,2016,M05,5.4,116430,2159095,2042665
Maryland,2009,M03,6.8,204278,3014580,2810302
Ohio,2014,M01,7.5,421570,5639928,5218358
South Carolina,2014,M05,5.9,130643,2223596,2092953
Louisiana,2013,M02,6.9,142397,2072713,1930316
Virginia,2016,M09,4.2,177096,4251219,4074123
Virginia,2001,M11,3.9,141904,3658826,3516922
Missouri,2005,M01,6.3,186917,2988135,2801218
Texas,2012,M09,6.4,809805,12719174,11909369
Wyoming,2004,M12,3.7,10114,273070,262956
North Dakota,2011,M04,3.6,13659,384695,371036
Georgia,2014,M09,6.9,329281,4755059,4425778
West Virginia,2015,M04,7.1,55517,785695,730178
Oklahoma,2009,M04,5.7,101187,1761793,1660606
Hawaii,2009,M09,7.6,47637,627477,579840
Arizona,2010,M12,9.6,292729,3050906,2758177
New Mexico,2009,M10,7.5,69982,937054,867072
Oregon,2008,M01,6.0,116293,1926216,1809923
Louisiana,2010,M12,7.9,163148,2067211,1904063
Massachusetts,2011,M06,7.6,266117,3509016,3242899
Wyoming,2016,M04,5.9,17953,301994,284041
Maryland,2003,M01,4.7,134618,2855272,2720654
Kansas,2004,M02,5.9,85779,1450693,1364914
Oregon,2003,M08,8.0,149471,1864318,1714847
Florida,2016,M10,4.9,490603,9932052,9441449
New York,2014,M12,5.5,525322,9510457,8985135
Montana,2016,M09,3.4,17809,525693,507884
Maine,2003,M11,4.8,32962,682916,649954
Washington,2004,M10,5.4,172919,3217029,3044110
Arkansas,2009,M01,8.0,107766,1348969,1241203
Nevada,2014,M06,8.1,112452,1396626,1284174
Kansas,2008,M10,4.7,71764,1510852,1439088
Ohio,2006,M08,5.4,327589,6021335,5693746
Oregon,2014,M06,6.8,132110,1949267,1817157
Georgia,2002,M02,5.1,217696,4297613,4079917
Oregon,2002,M01,9.0,163565,1817819,1654254
Nebraska,2010,M05,4.5,44666,995762,951096
Rhode Island,2000,M09,3.7,20358,543477,523119
Hawaii,2003,M01,3.9,23617,601628,578011
Michigan,2005,M02,7.8,391665,5048601,4656936
North Dakota,2007,M05,2.7,10127,368417,358290
Mississippi,2013,M05,8.9,113380,1280299,1166919
Texas,2006,M03,5.0,560206,11240252,10680046
Arizona,2003,M12,4.9,136322,2763645,2627323
Vermont,2011,M08,5.0,18130,359981,341851
Oregon,2004,M03,8.4,154219,1833640,1679421
Alaska,2012,M08,6.1,22532,370567,348035
Wyoming,2003,M12,4.2,11431,272845,261414
Kansas,2015,M11,3.6,53044,1492212,1439168
Kentucky,2007,M02,6.6,133120,2029059,1895939
Missouri,2011,M02,9.7,295449,3037388,2741939
Illinois,2009,M06,10.7,722580,6749041,6026461
Ohio,2013,M03,7.7,432891,5652905,5220014
Maryland,2002,M02,4.8,137432,2848036,2710604
Puerto Rico,2008,M08,12.8,172147,1340319,1168172
North Dakota,2013,M11,2.4,9783,405346,395563
Louisiana,2011,M02,7.9,162334,2048476,1886142
Vermont,2012,M05,4.8,16880,352997,336117
Illinois,2003,M08,7.0,444153,6320245,5876092
Pennsylvania,2007,M04,3.9,242619,6259729,6017110
New Jersey,2010,M10,9.0,408332,4528964,4120632
Connecticut,2012,M02,8.6,162857,1884684,1721827
Kentucky,2016,M11,4.2,84844,2002931,1918087
South Carolina,2010,M07,11.0,240106,2184329,1944223
North Dakota,2009,M04,4.4,16129,366404,350275
Iowa,2010,M08,5.8,96775,1675912,1579137
West Virginia,2012,M02,8.4,66980,801786,734806
Oklahoma,2010,M02,7.6,133624,1752656,1619032
Michigan,2005,M04,6.6,335036,5041140,4706104
Wisconsin,2010,M05,8.5,261427,3074285,2812858
Nebraska,2005,M01,4.6,44448,963938,919490
Washington,2007,M01,5.5,185732,3348067,3162335
Wisconsin,2015,M09,3.9,120002,3089177,2969175
Texas,2013,M03,6.2,798905,12784027,11985122
New York,2014,M04,6.1,574754,9499667,8924913
Mississippi,2016,M01,6.5,82377,1272194,1189817
Missouri,2016,M12,3.9,121063,3081307,2960244
Louisiana,2005,M08,6.1,127666,2086456,1958790
Oregon,2015,M03,6.1,117361,1936787,1819426
Arizona,2006,M04,4.1,122207,2958038,2835831
Maryland,2000,M07,3.8,108207,2845634,2737427
Alaska,2007,M09,5.6,19825,351903,332078
Indiana,2002,M08,5.0,159830,3194579,3034749
Nebraska,2004,M03,4.1,39864,964150,924286
New Hampshire,2005,M11,3.3,23985,726821,702836
Illinois,2000,M04,4.0,257230,6496573,6239343
Nebraska,2007,M02,3.4,32761,968192,935431
Missouri,2013,M07,7.2,220769,3066328,2845559
Wyoming,2009,M09,6.0,17897,299774,281877
South Dakota,2006,M01,3.7,15865,423075,407210
Maine,2001,M06,3.7,25004,684517,659513
Arkansas,2012,M01,8.5,113799,1340626,1226827
Texas,2004,M05,5.7,627992,10933173,10305181
Wisconsin,2006,M12,4.5,138699,3077236,2938537
Massachusetts,2010,M03,8.9,308887,3464646,3155759
Arizona,2004,M11,4.5,128512,2830647,2702135
Louisiana,2006,M09,4.2,83838,1988156,1904318
Idaho,2006,M08,3.0,22350,753495,731145
Mississippi,2002,M09,6.0,76766,1281816,1205050
Nebraska,2010,M10,4.1,41019,994417,953398
Maryland,2016,M10,4.2,133706,3187678,3053972
Nebraska,2014,M07,3.7,38274,1028599,990325
North Carolina,2009,M09,10.4,472231,4548553,4076322
Utah,2008,M06,3.7,50401,1379005,1328604
Mississippi,2007,M04,5.6,72694,1286941,1214247
Puerto Rico,2002,M05,12.2,161513,1323709,1162196
South Dakota,2002,M01,4.0,16136,406243,390107
Arizona,2007,M10,3.9,120280,3051467,2931187
Delaware,2000,M01,4.1,16722,403904,387182
Iowa,2000,M06,2.5,40709,1599578,1558869
District of Columbia,2000,M03,5.5,16737,306867,290130
Utah,2013,M08,4.6,64743,1417383,1352640
West Virginia,2011,M08,7.9,64025,809132,745107
Oklahoma,2013,M08,5.2,94138,1802971,1708833
North Dakota,2005,M08,3.1,11096,362308,351212
Washington,2014,M05,6.0,207359,3472799,3265440
Maine,2012,M02,8.8,61249,692727,631478
Utah,2003,M07,5.8,70133,1208606,1138473
Alabama,2006,M03,3.9,84273,2153266,2068993
Oregon,2005,M09,5.4,100336,1850868,1750532
Hawaii,2010,M10,6.9,44937,650539,605602
California,2003,M07,7.1,1233181,17302812,16069631
Maine,2002,M06,4.2,28441,685180,656739
Mississippi,2008,M01,6.5,84966,1313585,1228619
Alaska,2004,M11,7.2,24370,337342,312972
North Carolina,2013,M07,8.4,394884,4724507,4329623
New Jersey,2011,M09,9.2,419465,4552859,4133394
South Dakota,2009,M07,4.7,21485,455735,434250
Wyoming,2000,M06,3.7,10139,271906,261767
Texas,2001,M10,5.4,570954,10592613,10021659
Ohio,2012,M09,6.7,383100,5686686,5303586
Nevada,2012,M09,10.7,148000,1379448,1231448
Mississippi,2014,M07,8.3,105328,1262305,1156977
New Hampshire,2001,M10,3.6,25054,695619,670565
Illinois,2003,M04,6.3,395468,6260907,5865439
Ohio,2009,M10,10.3,607471,5877628,5270157
Utah,2004,M01,5.7,69200,1211870,1142670
South Carolina,2012,M04,8.8,192077,2176643,1984566
New York,2008,M04,4.6,439668,9579399,9139731
Florida,2011,M06,10.5,976692,9302716,8326024
California,2008,M11,8.4,1541436,18290251,16748815
Colorado,2014,M09,4.1,114502,2822310,2707808
Connecticut,2011,M03,9.3,178272,1909755,1731483
North Dakota,2011,M03,4.2,15942,382300,366358
Utah,2012,M05,5.3,72757,1369408,1296651
Connecticut,2004,M12,4.2,74028,1767394,1693366
Kansas,2006,M04,4.1,60237,1456382,1396145
Maine,2012,M11,7.0,49059,699856,650797
Kentucky,2004,M03,6.3,122667,1961473,1838806
Connecticut,2004,M01,5.7,100082,1763299,1663217
New Hampshire,2011,M01,6.0,44198,733580,689382
South Dakota,2004,M06,3.7,15985,436564,420579
Montana,2003,M04,4.7,22200,470037,447837
South Carolina,2004,M09,6.7,136406,2037435,1901029
Tennessee,2012,M08,8.1,249778,3093749,2843971
South Dakota,2002,M10,2.7,11146,420025,408879
Nevada,2012,M10,10.4,143357,1380107,1236750
Washington,2009,M11,9.9,350402,3525606,3175204
Oregon,2005,M06,6.2,115839,1857510,1741671
Alabama,2007,M11,3.9,85214,2192588,2107374
Alaska,2016,M05,6.6,23829,361669,337840
Wyoming,2014,M08,3.7,11437,308852,297415
Vermont,2008,M04,5.0,17377,349974,332597
Nebraska,2015,M12,3.0,29866,1005234,975368
Mississippi,2003,M03,6.4,82295,1288855,1206560
Iowa,2012,M02,6.0,98496,1652327,1553831
New Jersey,2004,M04,5.0,215219,4334235,4119016
Connecticut,2007,M01,4.8,88686,1833077,1744391
Kansas,2009,M01,6.2,93790,1509204,1415414
North Carolina,2008,M03,5.2,232743,4516291,4283548
Connecticut,2014,M08,6.7,127480,1905127,1777647
Oregon,2006,M05,5.0,92707,1868200,1775493
Pennsylvania,2000,M06,4.3,262955,6169254,5906299
Ohio,2013,M11,6.8,386846,5714830,5327984
Maryland,2001,M10,4.4,124375,2855739,2731364
Wisconsin,2007,M12,4.5,137540,3078715,2941175
New York,2011,M04,7.8,736437,9465985,8729548
Montana,2010,M10,6.6,32750,498109,465359
Missouri,2002,M10,4.6,138810,3004011,2865201
Ohio,2015,M05,4.9,279280,5732865,5453585
Pennsylvania,2008,M04,4.4,279057,6387954,6108897
South Dakota,2007,M06,2.7,12172,451142,438970
Wyoming,2002,M02,4.5,12011,265323,253312
North Dakota,2011,M08,3.4,13313,396881,383568
Georgia,2003,M05,4.9,213750,4389696,4175946
South Carolina,2006,M10,6.2,132168,2125984,1993816
Puerto Rico,2004,M02,10.8,143345,1328943,1185598
Massachusetts,2008,M04,4.6,157820,3412385,3254565
Indiana,2005,M07,5.4,174277,3242337,3068060
South Dakota,2013,M03,4.4,19376,441427,422051
Georgia,2013,M11,7.3,345669,4728205,4382536
Virginia,2008,M12,4.9,200335,4120692,3920357
Iowa,2002,M07,3.7,61571,1660629,1599058
Georgia,2010,M11,10.7,505909,4718830,4212921
South Dakota,2013,M02,4.6,20135,439251,419116
South Dakota,2006,M12,3.1,13432,435765,422333
Iowa,2008,M10,4.0,67004,1688781,1621777
District of Columbia,2016,M01,6.6,25527,389396,363869
California,2007,M10,5.4,968525,17961717,16993192
Virginia,2005,M09,3.5,138979,3918724,3779745
District of Columbia,2001,M05,5.8,17839,307599,289760
Washington,2013,M10,6.5,226774,3464438,3237664
Iowa,2005,M04,4.1,66707,1620112,1553405
Pennsylvania,2006,M03,4.8,299648,6230036,5930388
Kansas,2002,M12,4.5,64385,1416693,1352308
Nebraska,2011,M11,3.7,37341,1005667,968326
Wisconsin,2009,M12,8.9,272397,3059841,2787444
Louisiana,2016,M07,6.6,142515,2152264,2009749
Hawaii,2006,M01,2.6,16472,632848,616376
West Virginia,2000,M07,5.1,42009,817029,775020
Pennsylvania,2003,M09,5.1,315192,6139513,5824321
Iowa,2000,M12,2.9,46938,1595633,1548695
Oklahoma,2006,M07,4.0,68425,1728038,1659613
California,2002,M10,6.4,1108613,17312349,16203736
Missouri,2016,M01,4.6,140552,3082328,2941776
North Dakota,2016,M09,2.4,10058,417632,407574
Missouri,2007,M04,4.3,130889,3023447,2892558
Connecticut,2004,M05,5.0,88874,1773400,1684526
Missouri,2000,M03,3.9,116439,2951954,2835515
New York,2011,M09,8.3,789134,9515444,8726310
Montana,2000,M01,6.3,29146,462100,432954
Louisiana,2003,M05,6.5,130791,2017874,1887083
Connecticut,2002,M04,3.8,66444,1753810,1687366
Rhode Island,2010,M12,10.8,60991,564839,503848
Maryland,2005,M03,4.4,127013,2893488,2766475
Ohio,2007,M02,5.9,348758,5924116,5575358
Indiana,2007,M03,4.8,153770,3201318,3047548
Montana,2005,M09,3.6,17441,487385,469944
Alabama,2014,M05,6.6,143479,2164055,2020576
Hawaii,2000,M01,4.7,28571,605550,576979
New Jersey,2006,M04,4.9,216355,4420857,4204502
Kentucky,2015,M05,5.4,106032,1976094,1870062
Tennessee,2016,M08,5.2,163305,3149600,2986295
West Virginia,2011,M04,8.0,64921,807074,742153
Oklahoma,2013,M04,4.8,86442,1801767,1715325
North Dakota,2010,M01,4.8,17586,366092,348506
Wisconsin,2003,M07,5.8,178777,3089231,2910454
Mississippi,2016,M06,6.8,87736,1292264,1204528
Colorado,2010,M07,8.8,240357,2744763,2504406
New York,2015,M01,6.4,612104,9572557,8960453
Utah,2001,M10,4.4,51646,1170962,1119316
North Carolina,2010,M07,10.8,503704,4654443,4150739
Oregon,2013,M11,7.2,136883,1912930,1776047
Colorado,2006,M03,4.8,123882,2588083,2464201
Virginia,2015,M02,5.0,211908,4214455,4002547
Idaho,2007,M01,4.5,33667,746975,713308
Wyoming,2012,M02,6.0,18429,304974,286545
Florida,2013,M03,7.2,676136,9367451,8691315
Delaware,2009,M10,8.4,36285,429927,393642
Virginia,2003,M11,3.7,140634,3755684,3615050
Georgia,2010,M01,10.9,522646,4790880,4268234
Hawaii,2005,M02,2.9,18024,617654,599630
Vermont,2007,M09,3.8,13311,351728,338417
Kansas,2013,M09,4.9,72643,1482214,1409571
New Hampshire,2000,M07,2.6,18489,702183,683694
North Dakota,2006,M02,4.0,14036,354134,340098
Texas,2013,M08,6.3,812972,12872022,12059050
South Carolina,2003,M02,7.0,138924,1971890,1832966
Michigan,2001,M09,4.8,242395,5070136,4827741
New Mexico,2015,M02,6.7,61843,924059,862216
Montana,2000,M08,4.4,20914,475409,454495
New York,2005,M03,5.0,466757,9336553,8869796
Massachusetts,2003,M06,6.1,212892,3473127,3260235
Utah,2005,M09,3.9,49770,1287122,1237352
Michigan,2012,M03,9.4,437873,4649216,4211343
West Virginia,2007,M05,4.4,35788,810353,774565
Oklahoma,2001,M05,3.2,52609,1666455,1613846
Nebraska,2013,M06,4.1,42417,1031902,989485
Oregon,2006,M06,5.3,99804,1895358,1795554
Ohio,2013,M08,7.3,422008,5762252,5340244
Delaware,2007,M12,3.4,15164,446993,431829
Tennessee,2003,M07,5.9,174352,2935528,2761176
Michigan,2009,M10,13.6,660921,4872200,4211279
Montana,2011,M07,6.5,32954,510363,477409
California,2008,M12,9.0,1642244,18271924,16629680
Delaware,2006,M10,3.3,14504,441528,427024
New Mexico,2003,M11,5.6,50791,900897,850106
Iowa,2006,M03,4.1,66717,1642072,1575355
New York,2012,M05,8.4,810111,9612651,8802540
Georgia,2004,M07,5.2,232824,4483847,4251023
Kansas,2001,M03,4.3,59229,1389136,1329907
Georgia,2014,M10,6.7,317541,4768429,4450888
New Jersey,2006,M12,3.9,174282,4460383,4286101
Washington,2000,M02,5.9,181966,3076976,2895010
Illinois,2013,M06,9.7,645117,6667297,6022180
Oregon,2010,M10,9.7,192860,1993744,1800884
Texas,2000,M01,4.8,498187,10325502,9827315
North Dakota,2000,M07,2.7,9462,351350,341888
Maryland,2014,M08,6.0,189610,3147262,2957652
Massachusetts,2000,M06,2.8,94571,3368118,3273547
Iowa,2003,M02,5.1,81662,1613589,1531927
Arkansas,2012,M09,7.2,96516,1333956,1237440
Oregon,2002,M05,7.0,128030,1821418,1693388
Michigan,2001,M04,4.6,233331,5104406,4871075
New Mexico,2001,M09,4.7,40071,856375,816304
Montana,2004,M03,5.7,26803,474184,447381
